abandon = abndn
abandoned = abndnd
abandoning = abndng
abandonment = abndnm
abbreviate = abrvt
abbreviation = abrvz
abbreviations = abrvs
abdicate = abdct
abdicated = abdctd
abdomen = abdmn
abdominal = abdmnl
abduct = abduct
abhor = abhr
abide = abid
abided = abidd
abiding = abidg
abilities = ablts
ability = ablt
abject = abjct
able = ab
abnormal = abnrml
abnormalities = abnrmlts
abnormality = abnmlt
aboard = abord
abolish = abols
abort = abrt
abortion = abrz
abound = abnd
about = abt
above = abv
abrasion = abraz
abrasive = abrasv
abreast = abrst
abrupt = abrpt
absence = absnc
absent = absnt
absolute = abslut
absolutely = abslutl
absorb = absrb
absorbed = absrbd
absorbing = absrbg
absorbs = absrbs
abstract = abstrct
abstraction = abstrcz
absurd = absrd
abundance = abndnc
abundant = abndnt
abuse = abus
abused = abusd
academic = acdmc
accelerate = aclrt
accelerated = aclrtd
accelerates = aclrts
accelerating = aclrtg
acceleration = aclrz
accent = acent
accept = acpt
acceptable = acptb
acceptance = acptnc
accepted = acptd
accepting = acptg
accepts = acpts
access = acs
accessible = acsb
accident = acdnt
accidental = acdntl
accidentally = acdntll
accidents = acdnts
accommodate = acmdt
accommodating = acmdtg
accommodation = acmdz
accompanied = acpnd
accompanies = acpns
accompany = acmpn
accompanying = acmpng
accomplish = acpls
accomplished = acplsd
accomplishing = acplsg
accomplishment = acplsm
accomplishments = acplsms
accord = acrd
accordance = acrdnc
according = acrdg
accordingly = acrdgl
account = acnt
accountable = acntb
accounted = acntd
accounting = acntg
accounts = acnts
accumulate = acumlt
accumulated = acumltd
accumulates = acumlts
accumulating = acumltg
accumulation = acumlz
accuracy = acurc
accurate = acurt
accurately = acurtl
accuse = acus
accused = acusd
accustomed = acstmd
ache = ak
aches = aks
achievable = aceb
achieve = acev
achieved = acevd
achievement = acevm
achievements = acevms
achieves = acevs
achieving = acevg
aching = akg
acid = acd
acids = acds
acknowledge = aklj
acknowledged = akljd
acknowledgement = akljm
acquaint = acant
acquaintance = acntnc
acquaintances = acntncs
acquainted = acantd
acquire = acir
acquired = acird
acquiring = acirg
acres = acrs
across = acros
act = act
acted = actd
acting = actg
action = acz
actions = aczs
active = actv
actively = actvl
activities = actvts
activity = actvt
actor = actr
acts = acts
actual = actl
actually = actll
acute = acut
acutely = acutl
adapt = adap
adaptation = adapz
adapted = adapd
adapting = adapg
adapts = adaps
add = ad
added = add
addicting = adictg
adding = adg
addition = adz
additional = adzl
additions = adzs
address = adrs
addressed = adrsd
addresses = adrss
addressing = adrsg
adds = ads
adept = adep
adequate = adct
adequately = adctl
adhered = ahrd
adherence = adhrnc
adjacent = ajcnt
adjoin = ajn
adjoining = ajng
adjust = ajst
adjusted = ajstd
adjusting = ajstg
adjustment = ajstm
adjustments = ajstms
administer = amnstr
administration = amnstrz
admirable = amrb
admiration = amrz
admire = amir
admired = amird
admiring = amirg
admission = amiz
admit = amit
admits = amits
admitted = amitd
admitting = amitg
adopt = adop
adopted = adopd
adopting = adopg
adult = adlt
adults = adlts
advance = avnc
advanced = avncd
advancement = avncm
advancements = avncms
advances = avncs
advancing = avncg
advantage = avntj
advantageous = avntjus
advantages = avntjs
adventure = avntr
adventures = avntrs
adversaries = avrsrs
adverse = avrs
adversities = avrsts
adversity = avrst
advertising = avrtzg
advice = avic
advisable = avisb
advise = avis
advised = avisd
advising = avisg
advisors = avisrs
advocate = avoct
advocates = avocts
affair = afr
affairs = afrs
affect = afct
affected = afctd
affecting = afctg
affection = afcz
affects = afcts
affirm = afrm
affirmation = afrmz
affirmative = afrmtv
afflicted = aflctd
affliction = aflcz
afford = afrd
affordable = afrdb
afloat = aflot
afraid = afrad
after = af
afternoon = afnn
afterward = afwd
again = agn
against = agnst
age = aj
aged = ajd
agencies = ajncs
agency = ajnc
agenda = ajnda
agent = ajnt
agents = ajnts
ages = ajs
aggravate = agrvt
aggravating = agrvtg
aggravation = agrvz
aggression = agrz
aggressive = agrsv
aggressiveness = agrsvns
agile = ajil
agility = ajlt
aging = ajg
agitate = agtt
agitated = ajttd
ago = ag
agonize = agnz
agonizing = agnzg
agree = agre
agreed = agred
agreeing = agreg
agreement = agrem
agreements = agrems
agrees = agres
agricultural = agrcltrl
agriculture = agrcltr
ahead = ahd
aid = aid
aided = aidd
aim = am
aimed = amd
aiming = amg
aimless = amls
aimlessly = amlsl
aimlessness = amlsns
aims = ams
air = ar
aircraft = arcrft
airplane = arplan
airplanes = arplans
airport = arprt
alarm = alrm
alarmed = alrmd
alarming = alrmg
alarms = alrms
album = albm
alcohol = alchl
alcoholic = alchlc
alert = alrt
alerts = alrts
alien = alen
alienate = alent
alienated = alentd
alienating = alentg
align = alin
aligned = alind
alignment = alinm
alike = alik
alive = alv
all = al
allergic = alrgc
allergies = alrgs
allergy = alrg
alleviate = alevt
alliance = alinc
allies = alis
allocate = aloct
allocated = aloctd
allotment = alotm
allotted = alotd
allow = alo
allowance = alonc
allowed = alod
allowing = alog
allows = alos
alluded = aludd
alludes = aluds
allusion = aluz
ally = ali
almost = almo
aloft = alft
alone = alon
along = alg
aloud = alwd
already = alrd
also = aso
altar = altar
alter = altr
alteration = altrz
alterations = altrzs
altered = altrd
altering = altrg
alternate = altrnt
alternating = altrntg
alternative = altrntv
alternatives = altrntvs
although = altou
altitude = alttud
altogether = altgr
always = alws
am = m
amass = amas
amaze = amz
amazed = amzd
amazement = amzm
amazes = amzs
amazing = amzg
ambient = ambnt
ambiguity = ambgut
ambiguous = ambgus
ambition = ambz
ambitions = ambzs
ambitious = ambsus
ambivalence = ambvlnc
ambivalent = ambvlnt
ambling = amblg
ambush = ambus
amended = amndd
amendment = amndm
America = amrca
American = amrcn
Americans = amrcns
ammunition = amunz
among = amng
amount = amt
amounted = amtd
amounts = amts
amplify = amplfi
amuse = amus
amused = amusd
amusement = amusm
an = an
analogy = anlg
analysis = anlss
analytical = anltcl
analyze = anlz
analyzed = anlzd
analyzing = anlzg
ancestor = ancstr
ancestors = ancstrs
anchor = ancor
anchors = ancors
ancient = ancnt
and = x
angel = anjl
anger = angr
angle = angl
angles = angls
angry = angre
anguish = angis
anguished = angisd
anguishing = angisg
animal = anml
animals = anmls
animosities = anmosts
animosity = anmost
anniversaries = anvrsrs
anniversary = anvrsr
announce = annc
announced = anncd
announcement = anncm
annoy = any
annoyance = anync
annoyances = anyncs
annoyed = anyd
annoying = anyg
annoys = anys
annual = anul
another = anr
answer = ansr
answered = ansrd
answering = ansrg
answers = ansrs
anticipate = antcpt
anticipated = antcptd
anticipates = antcpts
anticipating = antcptg
anticipation = antcpz
anxieties = anxits
anxiety = anxit
anxious = anxus
any = ane
anybody = anbd
anybody's = anbds
anyhow = anhw
anymore = anmr
anyone = anon
anyplace = anplc
anything = ang
anytime = antim
anyway = anwa
anywhere = anwr
apart = aprt
apartment = aprtm
apartments = aprtms
apathetic = apatc
apathy = apat
apologies = aplgs
apologize = aplgz
appalled = apld
appalling = aplg
apparent = aprnt
apparently = aprntl
appeal = apel
appealed = apeld
appealing = apelg
appeals = apels
appear = aper
appearance = apernc
appearances = aperncs
appeared = aperd
appearing = aperg
appears = apers
appease = apes
appeased = apesd
appeasing = apesg
appended = apndd
appending = apndg
appetite = aptit
appetizer = aptizr
appetizers = aptizrs
appetizing = aptizg
applaud = aplud
applauded = apludd
applauding = apludg
applause = aplus
apple = apl
apples = apls
applicants = aplcnts
application = aplcz
applications = aplczs
applied = aplid
applies = aplis
apply = apli
applying = aplig
appoint = apnt
appointed = aptd
appointment = apntm
appointments = aptms
appraisal = aprasl
appraise = apras
appraised = aprasd
appreciate = aprct
appreciated = aprctd
appreciates = aprcts
appreciation = aprcz
appreciative = aprctv
apprehend = aprhnd
apprehension = aprhnz
apprehensive = aprhnsv
approach = aproc
approached = aprocd
approaches = aprocs
approaching = aprocg
appropriate = aprprt
appropriately = aprprtl
approval = aprvl
approve = aprv
approved = aprvd
approves = aprvs
approving = aprovg
approximate = aprxmt
approximately = aprxmtl
approximation = aprxmz
April = apr
arbitrary = arbtrr
arctic = artc
are = r
area = ara
areas = aras
aren't = rnt
argue = argu
argued = argud
arguing = argug
argument = argum
arguments = argums
arid = ard
arise = arz
arisen = arzn
arises = arzs
arising = arzg
arithmetic = artmtc
arm = arm
armed = armd
armor = armr
arms = arms
army = arme
arose = aroz
around = arnd
arrange = arnj
arranged = arnjd
arrangement = arnjm
arrangements = arnjms
arranging = arnjg
arrest = arst
arrested = arstd
arresting = arstg
arrival = arvl
arrivals = arvls
arrive = arv
arrived = arvd
arrives = arvs
arriving = arvg
arrogance = argnc
arrogant = argnt
arrow = aro
arrows = aros
arsenal = arsnl
arsenals = arsnls
art = art
article = artcl
articles = artcls
articulate = artclt
artificial = artfcl
artificially = artfcll
artist = artst
artistic = artstc
arts = arts
as = as
ascribe = ascrib
ashamed = asamd
ashes = ashs
aside = asid
ask = ask
asked = askd
asking = askg
asks = asks
asleep = aslep
aspect = aspct
aspects = aspcts
aspiration = asprz
aspirations = asprzs
aspire = aspir
assemble = asmbl
assembled = asmbld
assembling = asmblg
assembly = asmbll
assert = asrt
asserted = asrtd
asserting = asrtg
assertion = asrz
assertions = asrzs
assertive = asrtv
assertiveness = asrtvns
asserts = asrts
assess = ass
assessed = assd
assesses = asss
assessing = assg
assessment = assm
assessments = assms
asset = ast
assets = asts
assign = asin
assigned = asind
assigning = asing
assignment = asinm
assigns = asins
assist = asst
assistance = asstnc
assistant = assnt
assisted = asstd
assists = assts
associate = asoct
associated = asoctd
associates = ascots
association = asocz
associations = asoczs
assort = asort
assorted = asortd
assortment = asrtm
assume = asum
assumed = asumd
assumes = asums
assuming = asumg
assumption = asumz
assumptions = asumzs
assurance = asurnc
assurances = asurncs
assure = asur
assured = asurd
assures = asurs
assuring = asurg
astonish = astns
astonishes = astnss
astonishing = astnsg
astound = astond
astounded = astondd
astounding = astondg
astounds = astonds
astray = astra
astute = astut
astutely = astutl
at = at
ate = ate
athletic = atltc
athletics = atltcs
atmosphere = atmsfr
atom = atm
atomic = atmc
atoms = atms
atone = aton
atoned = atond
attach = atc
attached = atcd
attachment = atcm
attachments = atcms
attack = atk
attacked = atkd
attacking = atkg
attacks = atks
attain = atan
attainable = atanb
attained = atand
attempt = atmt
attempted = atmtd
attempting = atmtg
attempts = atmts
attend = atnd
attendance = atndnc
attended = atndd
attending = atndg
attention = atnz
attentive = atntv
attentively = atntvl
attest = atst
attests = atsts
attitude = attud
attitudes = attuds
attorney = atorn
attract = atrct
attracted = atrctd
attraction = atrcz
attractions = atrczs
attractive = atrctv
attracts = atrcts
attribute = atrbut
attributes = atrbuts
attune = atun
attuned = atund
audience = audnc
August = aug
aunt = ant
author = ator
authorities = atorts
authority = atort
authorized = atorzd
authors = ators
automatic = atmtc
automatically = atmtcl
automobile = atombl
automobiles = atombls
autumn = autm
availability = avlbt
available = avlb
avenue = avnu
avenues = avnus
average = avrj
averaged = avrjd
averaging = avrjg
avert = avrt
averted = avrtd
averting = avrtg
aviation = avaz
aviator = avatr
avoid = avyd
avoidable = avydb
avoidance = avydnc
avoided = avydd
avoiding = avydg
avoids = avyds
await = awat
awaiting = awatg
awaits = awats
awake = awak
awaken = awakn
awakening = awakng
awakes = awaks
awaking = awakg
award = awd
aware = awr
awareness = awrns
away = awa
awe = aw
awful = awf
awhile = awil
awkward = akwd
awoke = awok
axe = ax
babble = babl
babbling = bablg
babies = bbs
baby = bb
back = bk
backed = bkd
backfire = bkfir
backfired = bkfird
backfires = bkfirs
background = bkgrnd
backing = bkg
backs = bks
backtrack = bktrk
backtracking = bktrkg
backup = bkp
backward = bkwd
backwards = bkwds
bacteria = bctra
bad = bd
badge = bj
badges = bjs
badly = bdl
baffle = bfl
baffles = bfls
baffling = bflg
bag = bag
baggage = bgj
bags = bags
bailout = balot
bake = bak
baked = bakd
bakes = baks
baking = bakg
balance = blnc
balanced = blncd
balances = blncs
balancing = blncg
ball = bl
balloon = balon
balls = bls
bamboo = bmbo
ban = ban
bananas = bnns
band = bnd
bandage = bndj
bandit = bndt
bands = bnds
bandwagon = bndwgn
bang = bng
banish = bns
banished = bnsd
bank = bnk
banked = bnkd
banking = bnkg
bankrupt = bnkrpt
bankruptcy = bnkrpc
banks = bnks
bar = br
barbarian = brbrn
barbaric = brbrc
bare = bar
bared = bard
barely = barl
bares = bars
barest = barst
bargain = brgn
bargained = brgnd
bark = bark
barn = barn
barns = barns
barred = brrd
barrel = brl
barrels = brls
barrier = brr
barriers = brrs
bars = brs
base = bas
based = basd
bases = bases
basic = basc
basics = bascs
basis = bass
bask = bsk
basket = bskt
baskets = bskts
basking = bskg
basks = bsks
bat = bat
batch = btc
bath = bath
bathroom = batrm
batteries = batrs
battery = batr
battle = btl
battlements = btlms
battles = btls
battling = btlg
bay = bay
be = b
beach = bec
beached = becd
beaches = becs
beaching = becg
beacon = becn
beacons = becns
bead = bed
beads = beds
beam = bem
bean = ben
beans = bens
bear = ber
bearers = berrs
bearing = berg
bearings = bergs
bears = bers
beast = best
beasts = bests
beat = bet
beaten = betn
beating = betg
beats = bets
beautiful = buf
beautifully = bufl
beauty = but
became = bcam
because = bcs
beck = bek
beckon = bkn
beckoning = bkng
beckons = bkns
become = bcm
becomes = bcms
becoming = bcmg
bed = bdd
bedding = bdg
bedroom = bdrm
beds = bdds
bedtime = bdtim
been = bn
beep = bep
beeped = bepd
beeping = bepg
beer = beer
beers = beers
beetle = betl
beetles = betls
before = bf
beforehand = bfhnd
beg = beg
began = bgan
begging = bgg
begin = bgn
beginners = bgnrs
beginning = bgng
beginnings = bgngs
begins = bgns
begun = bgun
behalf = bhf
behave = bhv
behaved = bhvd
behaves = bhvs
behaving = bhvg
behavior = bhvr
behind = bhnd
behold = bhld
being = bg
beings = bgs
belief = blf
beliefs = blfs
believe = blv
believed = blvd
believes = blvs
believing = blvg
bell = bel
bellow = blw
bellows = blws
bells = bels
belong = blg
belonged = blgd
belonging = blngg
belongings = blggs
belongs = blgs
below = belo
belt = belt
belts = belts
bench = bnc
benches = bncs
bend = bend
bending = bndg
bends = bends
beneath = bnet
beneficial = bnfcl
benefit = bnft
benefited = bnftd
benefits = bnfts
benign = bnin
bent = bnt
berate = bert
berating = bratg
bereaved = brevd
bereavement = brevm
bereft = brft
berries = beris
berry = beri
beside = bsid
besides = bsids
best = bst
bet = bett
betray = btra
betrayed = btrad
betraying = btrag
betrays = btras
bets = betts
better = btr
between = btw
bevel = bvl
beveled = bvld
beware = bwr
beyond = byn
bias = bis
biased = bisd
Bible = bibl
bicycle = bccl
bicycles = bccls
bid = bid
bidder = bidr
bidding = bidg
big = big
bigger = bgr
biggest = bgst
bill = bil
billing = bilg
billion = biln
bills = bils
bind = bind
binder = bindr
binding = bindg
binds = binds
biological = biljcl
biology = bilog
bird = brd
birds = brds
birth = brt
birthday = brtda
birthdays = brtdas
bit = btt
bite = bit
bites = bites
biting = bitg
bits = btts
bitten = btn
bitter = bitr
bitterly = bitrl
bitterness = bitrns
bizarre = bzr
black = blk
blade = blad
blame = blam
blamed = blamd
blameless = blamls
blaming = blamg
blank = blnk
blanket = blnkt
blankets = blnkts
blanks = blnks
blast = blst
blaze = blaz
blazing = blazg
bleak = blek
bleed = bled
blend = blnd
blends = blnds
bless = bles
blessed = blesd
blessing = blsg
blessings = blsgs
blew = blew
blight = blit
blind = blind
blinding = blindg
blinds = blinds
blink = blink
blinking = blinkg
bliss = blis
blissful = blisf
blister = blstr
block = blok
blocked = blokd
blocking = blokg
blocks = bloks
blood = blod
bloody = blode
bloom = blom
blooming = blomg
blooms = bloms
blossom = blsm
blossoms = blsms
blow = blo
blowing = blog
blown = blon
blows = blos
blue = blu
bluff = bluf
blunder = blndr
blunders = blndrs
blunt = blnt
bluntly = blntl
blur = blr
blurred = blrd
blurring = blrg
board = board
boards = boards
boat = boat
boats = bots
bodies = bods
body = bod
bogged = bogd
boggle = bogl
boggles = bogls
boil = byl
boiled = byld
boiling = bylg
boils = byls
bold = bold
bolster = bolstr
bolt = bolt
bolts = bolts
bomb = bm
bombs = bms
bond = bonnd
bonds = bonnds
bone = bon
bones = bons
bonus = bnus
bonuses = bnuss
book = bok
booking = bokg
books = boks
boom = bom
booming = bomg
booms = boms
boost = bost
boot = boot
boots = boots
border = brdr
bordering = brdrg
borders = brdrs
bore = bor
bored = bord
boredom = bordm
boring = borg
born = born
borne = borne
borrow = boro
borrowed = borod
borrower = boror
borrowers = borors
borrowing = borog
borrows = boros
both = bo
bother = botr
bothered = botrd
bothering = botrg
bothers = botrs
bottle = botl
bottles = botls
bottom = btm
bottomless = btmls
bottoms = btms
bought = bot
boulder = boldr
bounce = bonc
bouncing = boncg
bound = bond
boundaries = bondrs
boundary = bondr
bounds = bonds
bounties = bonts
bountiful = bontf
bounty = bont
bow = bw
bowel = bowl
bowl = bwl
bowls = bwls
bows = bws
box = bx
boxed = bxd
boxes = bxs
boxing = bxg
boy = by
boys = bys
brace = brac
braced = bracd
braces = bracs
bracing = bracg
brag = brag
bragged = bragd
bragging = bragg
brain = bran
brains = brans
brainstorm = branstrm
brake = brak
brakes = braks
branch = brnc
branches = brncs
branching = brncg
brand = brnd
branded = brndd
branding = brndg
brands = brnds
brass = bras
bravado = brvdo
brave = brav
brazen = brzn
bread = bred
break = brk
breakdown = brkdw
breakfast = brkfst
breaking = brkg
breakneck = brknk
breaks = brks
breakthrough = brktrou
breakthroughs = brktrous
breath = bret
breathe = brete
breathed = bretd
breathing = bretg
breeze = brez
breezes = brezs
brew = brw
brewed = brwd
brewing = brwg
bribe = brib
brick = bric
bridge = brj
bridged = brjd
bridges = brjs
bridging = brjg
brief = bref
briefed = brefd
briefing = brefg
briefly = brefl
briefs = brefs
bright = brit
brighten = britn
brighter = britr
brightest = britst
brightly = britl
brilliance = brlnc
brilliant = brlnt
brilliantly = brlntl
brim = brm
brimmed = brmd
brimming = brmg
brims = brms
bring = brg
bringing = brgg
brings = brgs
brink = brnk
brisk = brsk
briskly = brskl
bristle = brsl
bristles = brsls
bristling = brslg
British = brits
broad = brod
broadcast = brdcst
broadly = brodl
broke = brok
broken = brokn
brooder = brodr
brother = bro
brothers = bros
brought = brot
brown = brwn
browse = brws
browsing = brwsg
brush = brus
brushed = brsd
brushes = brss
brushing = brsg
brutal = brutl
brute = brut
bubble = bbl
bubbled = bbld
bubbles = bbls
bubbling = bblg
bucket = bkt
buckets = bkts
buckle = bkl
buckled = bkld
buckles = bkls
buckling = bklg
budge = bdj
budged = bdjd
budget = bjt
budgeted = bjtd
budgeting = bjtg
budgets = bjts
budging = bdjg
buffer = bfr
buffers = bfrs
buffet = buft
buffets = bufts
bug = bug
bugging = bugg
buggy = buge
bugs = bugs
build = bld
builder = bldr
building = bldg
buildings = bldgs
builds = blds
built = blt
bulb = blb
bull = bul
bullet = bult
bulletin = bultn
bulletins = bultns
bump = bmp
bumped = bmpd
bumping = bmpg
bumps = bmps
bunch = bunc
bundle = bndl
bundled = bndld
bundles = bndls
bundling = bndlg
buoy = boy
buoys = boys
burden = brdn
burdened = brdnd
burdening = brdng
burdens = brdns
bureau = buro
bureaucracy = burocrc
bureaucratic = burocrtc
bureaus = buros
burial = burl
burials = burls
buried = burd
burn = brn
burned = burnd
burner = brnr
burning = brng
burnout = brnot
burns = brns
burst = brst
bursting = brstg
bursts = brsts
bury = bur
bus = bus
buses = buss
bush = bush
bushes = bushs
business = bzns
businesses = bznss
businessman = bznsmn
busy = bz
but = bt
butter = butr
butterfly = btrfli
button = butn
buttoning = butng
buttons = butns
buy = buy
buyer = buyr
buying = buyg
buys = buys
buzz = buz
by = bi
bye = bye
bypass = bips
bypassed = bipsd
bypassing = bipsg
cabbage = cbj
cabin = cbn
cabinet = cbnt
cabinets = cbnts
cabins = cbns
cable = cabl
cables = cabls
cadence = cadnc
cage = cj
cages = cjs
cake = cak
cakes = caks
calculate = clclt
calculated = clcltd
calculating = clcltg
calculation = clclz
calculations = clclzs
calendar = calndr
calendars = calndrs
calf = caf
California = ca
call = cal
called = cald
caller = calr
callers = calrs
calling = calg
calls = cals
calm = clm
calmed = clmd
calmer = clmr
calming = clmg
calmly = clml
calms = clms
calorie = calre
calories = calres
came = cam
camera = cmra
camp = cmp
campaign = cmpan
camping = cmpg
can = c
can't = cnt
Canada = cnda
canal = cnal
cancel = cncl
cancellation = cnclaz
cancellations = cnclazs
cancelled = cncld
cancer = cncr
cancers = cncrs
candidate = cddat
candidates = cddats
candies = cnds
candle = cndl
candles = cndls
candy = cnd
cane = can
canes = cans
cannot = cnot
cans = cns
canvas = cnvs
cap = cap
capabilities = capblts
capability = capbt
capable = capb
capacity = capct
capital = cptl
capitalize = cptlz
capitals = cptls
caps = caps
captain = cptn
captivating = cptvtg
captive = cptv
captivity = cptvt
capture = cptur
captured = cpturd
captures = cpturs
capturing = cpturg
car = cr
carbon = crbn
card = crd
cardboard = crdbrd
cards = crds
care = car
cared = card
career = crer
careers = crers
carefree = carfre
careful = carf
carefully = carfl
careless = carls
carelessness = carlsns
cares = cars
caress = cres
cargo = crgo
caring = carg
carnival = crnvl
carriage = carj
carried = cared
carries = cares
carry = care
carrying = careg
cart = cart
cartridge = crtrj
carts = carts
carve = carv
carved = carvd
case = cas
cases = cass
cash = cs
cashed = csd
cashing = csg
casket = cskt
caskets = cskts
cast = cast
castle = casl
castles = casls
casts = casts
casual = csul
casually = csull
cat = cat
catalog = ctlg
catalogs = ctlgs
catastrophe = ctstrf
catastrophes = ctstrfs
catch = ctc
catches = ctcs
catching = ctcg
categories = ctgrs
categorize = ctgrz
category = ctgr
catering = catrg
cats = cats
cattle = ctl
caught = cwt
cause = cws
caused = cwsd
causes = cwss
causing = cwsg
caution = cwz
cautions = cwzs
cautious = cwsus
cave = cav
cavern = cvrn
ceased = cesd
ceases = cess
ceiling = celg
celebrate = clbrt
celebrated = clbrtd
celebrating = clbrtg
celebration = clbrz
celebrations = clbrzs
cell = cel
cells = cels
cement = cem
cemetery = cmtr
censor = cnsr
censors = cnsrs
cent = cent
center = cntr
centered = cntrd
centerpiece = cntrpc
centers = cntrs
central = cntrl
cents = cnts
centuries = cnturs
century = cntur
ceremonies = crmons
ceremony = crmn
certain = crtn
certainly = crtnl
certainty = crtnt
certificate = crtfct
certificates = crtfcts
certification = crtfcz
certified = crtfid
certify = crtfi
chain = cain
chained = caind
chains = cains
chair = cair
chairman = carmn
chairs = cairs
chalk = calk
challenge = clnj
challenged = clnjd
challenges = clnjs
challenging = clnjg
chamber = cambr
chambers = cambrs
champion = cmpon
chance = cnc
chanced = cncd
chances = cncs
change = cnj
changed = cnjd
changes = cnjs
changing = cnjg
channel = cnl
channels = cnls
chant = cant
chaos = caos
chaotic = caotc
chapter = cptr
chapters = cptrs
character = crctr
characteristic = crctrstc
characteristics = crctrstcs
characterize = crctrz
characters = crctrs
charge = crj
charged = crjd
charges = crjs
charm = crm
charmed = crmd
chart = crt
charts = crts
chase = chas
chased = chasd
chases = chass
chasing = chasg
chat = chat
cheap = cep
cheaper = cepr
cheat = cet
cheated = cetd
cheating = cetg
check = ck
checked = ckd
checker = ckr
checking = ckg
checklist = cklst
checks = cks
cheek = cek
cheeks = ceks
cheer = cer
cheerful = cerf
cheerfully = cerfl
cheese = ces
chemical = cmcl
chemicals = cmcls
chemistry = cmstr
cherish = ceris
chest = cest
chests = cests
chicken = ckn
chickens = ckns
chief = cef
chiefly = cefl
chiefs = cefs
child = cild
child's = cilds
childhood = cildhd
children = cildn
chill = cil
chilling = cilg
chills = cils
chin = cin
china = cina
Chinese = cines
chins = cins
chip = cip
chipped = cipd
chipping = cipg
chips = cips
chisel = cisl
chiseling = cislg
chisels = cisls
chocolate = coclt
chocolates = coclts
choice = cyc
choices = cycs
choose = coos
chooses = cooss
choosing = coosg
chose = cos
chosen = cosn
Christmas = crstms
chronic = cronc
chronically = croncll
chronological = crnljcl
chronologically = crnljcll
chuck = cuk
chucked = cukd
chucking = cukg
chunk = cnk
chunked = cnkd
chunking = cnkg
chunks = cnks
chunky = cnke
church = crc
churches = crcs
churn = curn
churning = curng
circle = crcl
circled = crcld
circles = crcls
circling = crclg
circuit = circt
circuits = circts
circular = crclr
circulate = crcult
circulating = crcltg
circumstance = crcstnc
circumstances = crcstncs
circumvent = crcmvnt
circumventing = crcmvntg
circumvents = crcmvnts
circus = crcus
cities = ctes
citizen = ctzn
citizens = ctzns
city = cte
civil = cvl
civilian = cvln
civilization = cvlzz
civilized = cvlzd
clad = clad
claim = clam
claimed = clamd
claiming = clamg
claims = clams
clamor = clmor
clarification = clrfcz
clarify = clrfi
clarity = clrt
clash = clas
clashes = class
class = cls
classed = clsd
classes = clss
classic = clsc
classical = clscl
classics = clscs
classification = clasfcz
classified = clsfid
classifies = clsfis
classify = clsfi
classing = clsg
claw = clw
clawing = clwg
claws = clws
clay = cla
clean = cln
cleaned = clnd
cleaner = clnr
cleaning = clng
cleanly = clnl
cleans = clns
cleanse = clnss
clear = clr
cleared = clrd
clearer = clrr
clearest = clrst
clearing = clrg
clearly = clrl
clears = clrs
clerk = clrk
clever = clvr
cleverly = clvrl
cleverness = clvrns
click = clik
clicked = clikd
clicking = clikg
clicks = cliks
cliff = clif
climate = climt
climb = clim
climbed = climd
climber = climr
climbing = climg
climbs = clims
clinch = clinc
cling = clg
clinging = clgg
clings = clgs
clinic = clnc
clinical = clncl
clinically = clncll
clinics = clncs
clip = clp
clipped = clpd
clipping = clpg
clips = clps
cloak = clok
cloaks = cloks
clock = clk
clocks = clks
close = clos
closed = closd
closely = closl
closer = closr
closes = closs
closest = closst
closet = clst
closing = closg
cloth = clot
clothes = clots
clothing = clotg
cloud = clwd
clouded = clwdd
clouds = clwds
cloudy = clwde
club = clb
clubs = clbs
clue = clu
clues = clus
clumsiness = clmsns
clumsy = clmse
cluster = clstr
clusters = clstrs
clutter = cltr
cluttered = cltrd
clutters = cltrs
coach = coc
coached = cocd
coaches = cocs
coaching = cocg
coal = coal
coarse = coars
coast = cost
coastal = costl
coasting = costg
coasts = costs
coat = cot
coated = cotd
coating = cotg
coats = cots
coax = cox
coaxed = coxd
coaxes = coxs
coaxing = coxg
cobweb = cbwb
cobwebs = cbwbs
coddle = cdl
coddled = cdld
coddles = cdls
code = cod
coded = codd
codes = cods
coding = codg
coffee = cofe
coffin = cofn
coffins = cofns
cognition = cgnz
cognitive = cgntv
coherence = cohrnc
coherent = cohrnt
coherently = cohrntl
coil = cyl
coiling = cylg
coils = cyls
coin = cyn
coined = cyned
coins = cyns
cold = cld
colder = cldr
colds = clds
collaborate = colbrt
collaboration = colbrz
collapse = colps
collapsed = colpsd
collapses = colpss
collapsing = colpsg
colleague = coleg
collect = clct
collected = clctd
collecting = clctg
collection = clcz
collections = clczs
collective = clctv
college = colj
colleges = coljs
colonies = colns
colony = coln
color = clor
colored = clord
colorful = clorf
coloring = clorg
colors = clors
column = colm
columns = colms
comb = com
combat = cbt
combated = cbtd
combating = cbtg
combats = cbts
combed = comd
combination = cbnz
combinations = cbnzs
combine = cbin
combined = cbind
combines = cbins
combing = comg
combining = cbing
combs = coms
come = cm
comes = cms
comfort = cfrt
comfortable = cfrtb
comfortably = cfrtbl
comforted = cfrtd
comforting = cfrtg
comforts = cfrts
coming = cmg
command = cmnd
commanded = cmdd
commander = cmdr
commanding = cmndg
commands = cmds
commemorate = cmmrt
commence = cmnc
commend = cmend
commended = cmendd
comment = cmm
commentary = cmntr
commenting = cmmg
comments = cmms
commerce = cmrc
commercial = cmrsl
commission = cmz
commit = cmt
commitment = cmtm
commitments = cmtms
commits = cmts
committed = cmtd
committee = cmte
commodity = comdt
common = cmn
commonly = cmnl
commonplace = cmnplc
commotion = cmoz
communicate = cmnct
communicated = cmnctd
communicates = cmncts
communicating = cmnctg
communication = cmncz
communications = cmnczs
communities = cmunts
community = cmunt
compact = cpct
companies = cpns
companion = cpnn
companionship = cpnzp
company = cpn
comparable = cparb
comparative = cpartv
compare = cpar
compared = cpard
compares = cpars
comparison = cparsn
comparisons = cparsns
compartments = cprtms
compass = cpas
compassion = cpz
compassionate = cpzt
compatible = cptb
compel = cpl
compelled = cpld
compelling = cplg
compels = cpls
compensate = cpnst
compensated = cpnstd
compensates = cpnsts
compensation = cpnsz
compensations = cpnszs
compete = cpet
competed = cpetd
competence = cptnc
competent = cptnt
competently = cptntl
competes = cpets
competing = cpetg
competition = cpetz
competitive = cpttv
compilation = cpilz
compile = cpil
compiled = cpild
complacent = cplcnt
complain = cplan
complained = cpland
complaining = cplang
complains = cplans
complaint = cplant
complaints = cplants
complete = cplet
completed = cpletd
completely = cpletl
completes = cplets
completing = cpletg
completion = cplez
complex = cplx
complexes = cplxs
complexities = cplxts
complexity = cplxt
compliance = cplinc
compliant = cplint
complicate = cplct
complicated = cplctd
complicates = cplcts
complicating = cplctg
complication = cplcz
complications = cplczs
complied = cplid
compliment = cplm
complimentary = cplmntr
compliments = cplms
comply = cpli
component = cpnnt
components = cponnts
compose = cpos
composed = cposd
composes = cposs
composing = cposg
composite = cposit
composition = cposz
compositions = cposzs
composure = cposr
compound = cpnd
compounds = cpnds
comprehend = cprhnd
comprehending = cphndg
comprehensible = cprhnsb
comprehension = cprhnz
comprehensive = cprhnsv
compress = cprs
compressed = cprsd
compressing = cprsg
compromise = cprmz
compromises = cprmzs
compulsion = cplz
compulsive = cplsv
computation = cputz
computations = cputzs
compute = cput
computed = cputd
computer = cputr
computers = cputrs
computing = cputg
conceit = ccet
conceivable = ccevb
conceive = ccev
conceived = ccevd
concentrate = cctrt
concentrated = cctrtd
concentrates = cctrts
concentrating = cctrtg
concentration = cctrz
concept = ccpt
conception = ccpz
concepts = ccpts
conceptual = ccptul
concern = ccrn
concerned = ccrnd
concerning = ccrng
concerns = ccrns
concert = ccrt
concerted = ccrtd
concessions = cczs
concise = ccis
concisely = csisl
conclude = cclud
concluded = ccludd
conclusion = ccluz
conclusions = ccluzs
concrete = ccret
concur = ccur
concurrent = ccurnt
condemn = cdm
condense = cdns
condensed = cdnsd
condition = cdz
conditions = cdzs
conducive = cducv
conduct = cdct
conductive = cductv
conference = cfrnc
confide = cfid
confidence = cfdnc
confident = cfdnt
confidential = cfdnsl
confidently = cfdntl
configure = cfgr
confine = cfin
confined = cfind
confines = cfins
confining = cfing
confirm = cfirm
confirmation = cfirmz
confirmed = cfirmd
confirms = cfirms
conflict = cflct
conflicting = cflctg
conflicts = cflcts
conform = cfrm
conformed = cfrmd
conforming = cfrmg
conforms = cfrms
confront = cfrnt
confrontation = cfrntz
confronted = cfrntd
confronting = cfrntg
confuse = cfus
confused = cfusd
confuses = cfuss
confusing = cfusg
confusion = cfuz
confusions = cfuzs
congenial = cgnl
congratulate = cgrtlt
congratulations = cgrts
congress = cgrs
congressional = cgrszl
conjunction = cjncz
conjure = cjur
conjures = cjurs
connect = cnct
connected = cnctd
connecting = cnctg
connection = cncz
connections = cnczs
connects = cncts
conquer = ccr
conquered = ccrd
conquering = ccrg
conquers = ccrs
conscious = csus
consciously = csusl
consciousness = csusns
consensus = csnss
consent = csnt
consented = csntd
consenting = csntg
consents = csnts
consequence = cscnc
consequences = cscncs
consequential = cscnsl
consequently = csctl
conservation = csrvz
conservative = csrvtv
conserve = csrv
conserved = csrvd
conserves = csrvs
conserving = csrvg
consider = csdr
considerable = csdrb
considerably = csdrbl
considerate = csdrt
consideration = csdrz
considerations = csdrzs
considered = csdrd
considering = csdrg
considers = csdrs
consist = csst
consisted = csstd
consistency = csstnc
consistent = csstnt
consistently = csstntl
consisting = csstg
consists = cssts
consolation = csolz
consolations = csolzs
console = csol
consolidate = csldt
consolidated = csldtd
consolidation = csoldz
conspicuous = cspcus
conspiracy = cspirc
conspire = cspir
conspired = cspird
conspires = cspirs
conspiring = cspirg
constant = cstnt
constantly = cstntl
constants = cstnts
consternation = cstrnz
constitute = csttut
constitutes = csttuts
constitution = csttuz
constrain = cstran
constrained = cstrand
constraints = cstrants
constrict = cstrict
constricted = cstrictd
constricting = cstrictg
construct = cstrct
constructed = cstrctd
constructing = cstrctg
construction = cstrcz
constructions = cstrczs
constructive = cstrctv
constructively = cstrctvl
constructs = cstrcts
consult = csult
consultant = csultnt
consultation = csultz
consume = csum
consumed = csumd
consumer = csumr
consumes = csums
consuming = csumg
contact = ctct
contacted = ctctd
contacting = ctctg
contacts = ctcts
contagious = ctajus
contain = ctan
contained = ctand
container = ctanr
containers = ctanrs
containing = ctang
contains = ctans
contaminate = ctmnt
contaminated = ctmntd
contamination = ctmnz
contemplate = ctmplt
contemplated = ctmpltd
contemplating = ctmpltg
contemplation = ctmplz
contemplative = ctmpltv
contempt = ctmt
contemptible = ctmtb
contend = ctnd
contended = ctndd
content = ctnt
contented = ctntd
contention = ctnz
contentment = ctntm
contents = ctnts
contest = ctst
context = ctxt
contexts = ctxts
continent = ctnnt
continents = ctnnts
contingency = ctnjnc
contingent = ctnjnt
continual = ctnul
continually = ctnull
continuation = ctnuz
continue = ctnu
continued = ctnud
continues = ctnus
continuing = ctnug
continuity = ctnut
continuous = ctnuus
continuously = ctnusl
contract = ctrct
contracted = ctrctd
contracting = ctrctg
contraction = ctrcz
contractions = ctrczs
contracts = ctrcts
contradict = ctrdct
contradicting = ctrdctg
contradiction = ctrdcz
contradictions = ctrdczs
contradictory = ctrdctr
contrary = ctrr
contrast = ctrst
contrasted = ctrstd
contrasting = ctrstg
contrasts = ctrsts
contribute = ctrbut
contributed = ctrbutd
contributes = ctrbuts
contributing = ctrbutg
contribution = ctrbuz
contributions = ctrbuzs
control = ctrl
controlled = ctrld
controlling = ctrlg
controls = ctrls
controversy = ctrvrs
convenience = cvnnc
convenient = cvnnt
conveniently = cvnntl
convention = cvnz
conventional = cvnzl
conversation = cvrsz
conversations = cvrszs
converse = cvrs
conversion = cvrz
convert = cvrt
converted = cvrtd
converter = cvrtr
convey = cva
conveyed = cvad
conveying = cvag
conveys = cvas
convict = cvct
convicted = cvctd
convicting = cvctg
conviction = cvcz
convictions = cvczs
convicts = cvcts
convince = cvnc
convinced = cvncd
convinces = cvncs
convincing = cvncg
convolute = cvlut
convoluted = cvlutd
convolution = cvluz
convolutions = cvluzs
cook = cok
cooked = cokd
cookies = cokes
cooking = cokg
cooks = coks
cool = col
cooled = cold
cooler = colr
cooling = colg
cools = cols
cooperate = coprt
cooperated = coprtd
cooperating = coprtg
cooperation = coprz
cooperative = coprtv
coordinate = crdnt
coordinated = crdntd
coordinates = cordnts
coordinating = crdntg
coordination = crdnz
cope = cop
coped = copd
copied = cpd
copies = cps
coping = copg
copper = copr
copy = cp
copying = cpg
cord = cord
core = cor
cork = cork
corn = crn
corner = crnr
corners = crnrs
corporation = crprz
corral = corl
correct = crct
corrected = crctd
correcting = crctg
correction = crcz
corrections = crczs
corrective = crctv
correctly = crctl
corrects = crcts
correlate = corlt
correlated = corltd
correlation = corlz
correspondence = crspndnc
corresponding = crspndg
corresponds = crspnds
corrosion = corz
corrosive = corsv
corrupt = corpt
corruption = crpz
cost = cst
costing = cstg
costs = csts
cotton = ctn
cough = cuf
coughed = cufd
coughing = cufg
coughs = cufs
could = cd
couldn't = cdnt
council = concl
counselor = conslr
count = cont
counted = contd
counter = contr
counteract = contract
counting = contg
countless = contls
countries = contrs
country = cuntr
counts = conts
county = conte
couple = cupl
coupled = cupld
couples = cupls
coupling = cuplg
courage = curj
courageous = curjus
course = cors
courses = corss
coursing = corsg
court = cort
courtesy = curts
cousin = cusin
cove = cov
cover = cv
coverage = cvj
covered = cvd
covering = cvg
coverings = cvgs
covers = cvs
cow = cw
coward = cwd
cowboy = cwby
cows = cows
crabby = crbb
crack = crk
cracked = crkd
cracking = crkg
crackle = crkl
cracks = crks
craft = crft
crafted = crftd
craftsmanship = crfsmnzp
cramp = crmp
cramped = crmpd
cramping = crmpg
crank = crnk
cranked = crnkd
cranking = crnkg
crash = crs
crashed = crsd
crashes = crss
crashing = crsg
crave = crav
craved = cravd
craves = cravs
craving = cravg
cravings = cravgs
crawl = crwl
crawled = crwld
crawling = crwlg
crawls = crwls
craze = craz
craziness = crzns
crazy = crz
cream = crem
creamed = cremd
create = cret
created = cretd
creates = crets
creating = cretg
creation = crez
creative = cretv
creatively = cretvl
creativity = cretvt
creature = cretr
creatures = cretrs
credibility = crdbt
credible = crdb
credit = crdt
credits = crdts
creek = crek
creeks = creks
creep = crep
creeping = crepg
creeps = creps
crept = crpt
crest = crst
crested = crstd
crests = crsts
crew = crw
crews = crws
cried = crid
cries = cris
crime = crim
criminal = crmnl
cringe = crnj
cringed = crnjd
cringing = crnjg
crippled = crpld
crippling = crplg
crises = crises
crisis = criss
crisp = crsp
crisped = crspd
criteria = critra
criterion = critrn
critic = crtc
critical = crtcl
critically = crtcll
criticism = crtcsm
criticisms = crtcsms
criticize = crtcz
criticized = crtczd
criticizes = crtczs
critics = crtcs
crop = crp
cropped = crpd
cropping = cropg
crops = crps
cross = cros
crossed = crosd
crosses = cross
crossing = crosg
crow = cro
crowd = crwd
crowded = crwdd
crowding = crwdg
crowds = crwds
crown = crwn
crowning = crwng
crucial = crucl
crude = crud
cruel = crul
cruelty = crult
cruise = cruz
crumble = crmbl
crumbles = crmbls
crumbling = crmblg
crunch = crnc
crunched = crncd
crunching = crncg
crush = crus
crushed = crusd
crushes = cruss
crushing = crusg
crust = crust
crusts = crusts
crux = crx
cry = cri
crying = crig
cryptic = crptc
crystal = crstl
crystalline = crstln
crystallize = crstlz
crystals = crstls
cue = cue
cues = cues
cull = cul
culled = culd
culling = culg
culls = culs
culminate = clmnt
culminated = clmntd
culminates = clmnts
culmination = clmnz
culprit = clprt
cult = clt
cultivate = cltvt
cultivated = cltvtd
cultivating = cltvtg
cultivation = cltvz
cults = clts
culturally = cultrll
culture = cultr
cultured = cultrd
cultures = cultrs
cumbersome = cmbrsm
cumulative = cmltv
cunning = cng
cup = cup
cups = cups
curb = crb
curbed = crbd
curbing = crbg
curbs = crbs
cure = cur
cured = curd
curiosity = curst
curious = curus
curiously = cursl
curl = crl
curled = crld
curling = crlg
curls = crls
current = crnt
currently = crntl
currents = crnts
curse = curs
cursed = cursd
cursing = cursg
curt = curt
curtail = crtal
curtailed = crtald
curtain = curtn
curtly = crtl
curve = crv
curved = curvd
curves = crvs
curving = crvg
cushion = cuz
cushioned = cuzd
cushioning = cuzg
cushions = cuzs
cusp = csp
cusps = csps
custom = cstm
customer = cstmr
customers = cstmrs
customs = cstms
cut = ct
cuts = cts
cutting = ctg
cycle = cicl
cycled = cicld
cycles = cicls
cylinder = clndr
cynic = cnic
cynical = cincl
daily = dal
dairy = dair
dallied = dalld
dally = dall
dallying = dallg
dam = dm
damage = dmj
damaged = dmjd
damages = dmjs
damaging = dmjg
damp = dmp
dampen = dmpn
dampens = dmpns
dance = dnc
danced = dncd
dances = dncs
dancing = dncg
danger = dnjr
dangerous = dnjrus
dangerously = dnjrusl
dangers = dnjrs
dangle = dngl
dangling = dnglg
dare = dar
dared = dard
dares = dars
daring = darg
dark = drk
darker = drkr
darkest = drkst
darkness = drkns
dashed = dsd
dashes = dss
dashing = dsg
data = dta
date = dat
dated = datd
dates = dats
dating = datg
daughter = dutr
daughters = dutrs
daunting = duntg
dawn = dwn
dawned = dwnd
dawning = dwng
dawns = dwns
day = da
daylight = dalit
days = das
daze = daz
dead = dead
deadening = ddng
deaf = def
deafen = defn
deafening = defng
deal = del
dealer = delr
dealers = delrs
dealing = delg
deals = dels
dealt = dlt
dear = der
death = det
deaths = dets
debatable = dbatb
debate = dbt
debated = dbtd
debates = dbts
debating = dbtg
debt = dt
debts = dts
decade = dcad
decadence = dcdnc
decadent = dcadnt
decades = dcads
decay = dca
decays = dcas
decease = dces
deceased = dcesd
deceit = dcet
deceits = dcets
deceive = dcev
deceived = dcevd
deceiving = dcevg
December = dec
decent = dcnt
decently = dcntly
deception = dcpz
deceptive = dcptv
decide = dcid
decided = dcidd
decides = dcids
deciding = dcidg
decipher = dcifr
decision = dcz
decisions = dczs
decisive = dcisv
decisively = dcisvl
decks = dks
declare = dclar
declared = dclrd
declares = dclrs
decline = dclin
declined = dclind
declining = dcling
deconstruct = dcstrct
decorate = dcrt
decoration = dcrz
decorations = dcrzs
decoy = dcoy
decoys = dcoys
decrease = dcrs
decreased = dcrsd
decreases = dcrss
decreasing = dcrsg
decreed = dcred
dedicate = ddct
dedicated = ddctd
dedication = ddcz
deed = ded
deeds = deds
deemed = demd
deep = dep
deepen = depn
deeper = depr
deepest = depst
deeply = depl
default = dfalt
defeat = dfet
defeated = dfetd
defeating = dfetg
defeats = dfets
defend = dfnd
defended = dfndd
defending = dfndg
defends = dfnds
defense = dfns
defenses = dfnss
defensive = dfnsv
defer = dfer
deferred = dferd
deferring = dferg
deficiency = dfncc
deficient = dfcnt
deficit = dfct
deficits = dfcts
defies = dfis
define = dfin
defined = dfind
defines = dfins
defining = dfing
definite = dfnt
definitely = dfntl
definition = dfnz
definitions = dfnzs
definitive = dfntv
deflect = dflct
deflects = dflcts
deft = dft
defy = dfi
degree = dgre
degrees = dgres
delay = dla
delayed = dlad
delaying = dlag
delays = dlas
delegate = dlgt
delegated = dlgatd
delete = dlet
deleted = dletd
deletes = dlets
deliberate = dlbrt
deliberately = dlbrtl
deliberation = dlbrz
delicacy = dlcc
delicate = dlct
delicately = dlctl
delicious = dlsus
delight = dlit
delighted = dlitd
delightful = dlitf
deliver = dlv
delivered = dlvd
delivering = dlvg
delivers = dlvrs
delivery = dlvr
deluded = dludd
deluding = dludg
delusion = dluz
delusional = dluznl
delusions = dluzs
delve = delv
delved = delvd
delves = delvs
delving = delvg
demand = dmnd
demanded = dmndd
demanding = dmndg
demands = dmnds
demeanor = dmenr
demon = dmon
demons = demns
demonstrate = dmnstrt
demonstrated = dmnstrtd
demonstrates = dmnstrats
demonstrating = dmstrtg
demonstration = dmnstrz
den = den
denial = dnil
denials = dnils
denied = dnid
denies = dnis
denounce = dnnc
denounced = dnncd
dens = dens
dense = dns
densities = dnsts
density = dnst
dentist = dntst
deny = dni
denying = dnig
departed = dprtd
departing = dprtg
department = dprtm
departments = dprtms
departure = dprtur
departures = dprturs
depend = dpnd
dependability = dpndbt
dependable = dpndb
dependably = dpndbl
depended = dpndd
dependence = dpndnc
dependent = dpndnt
depending = dpndg
depends = dpnds
depict = dpct
deploy = dply
deposit = dpost
deposits = dposts
depress = dprs
depressed = dprsd
depresses = dprss
depressing = dprsg
depression = dprz
deprivation = dprvz
deprived = dprivd
depriving = dprivg
depth = dpt
depths = dpts
derail = dral
derive = driv
derived = drivd
descendant = dcndnt
describe = dscrib
described = dscribd
describes = dscribs
describing = dscribg
description = dscrpz
descriptions = dscrpzs
descriptive = dscrptv
desert = dsrt
deserts = dsrts
deserve = dsrv
deserved = dsrvd
deserves = dsrvs
deserving = dsrvg
design = dsin
designated = dsgntd
designation = dsgnz
designed = dsind
designs = dsins
desirable = dsirb
desire = dsir
desired = dsird
desires = dsirs
desk = dsk
desks = dsks
despair = dspar
desperate = dsprt
desperately = dsprtl
desperation = dsprz
despise = dspis
despised = dspisd
despises = dspiss
despite = dspit
destination = dstnz
destined = dstnd
destiny = dstn
destroy = dstry
destroyed = dstryd
destroying = dstryg
destroys = dstrys
destruction = dstrucz
destructive = dstrctv
detach = dtac
detached = dtcd
detaches = dtacs
detaching = dtacg
detachment = dtcm
detail = dtal
detailed = dtald
detailing = dtalg
details = dtals
detect = dtct
detectable = dtctb
detected = dtctd
detection = dtcz
detector = dtctr
detectors = dtctrs
detects = dtcts
deter = dtr
deteriorate = dtrrt
deteriorated = dtrrtd
deteriorates = dtrrts
deteriorating = dtrrtg
deterioration = dtrrz
determination = dtrmnz
determine = dtrmn
determined = dtrmnd
determines = dtrmns
determining = dtrmng
deterred = dtrd
deterring = dtrg
deters = dtrs
detest = dtst
detested = dtstd
detests = dtsts
detract = dtrct
detracts = dtrcts
detriment = dtrim
devalue = dvlu
devastate = dvstt
devastated = dvsttd
devastating = dvsttg
develop = dvlp
developed = dvlpd
developing = dvlpg
development = dvlpm
developments = dvlpms
develops = dvlps
deviation = dvaz
device = dvic
devices = dvics
devil = dvl
devilish = dvls
devious = dvus
devise = dvis
devised = dvisd
devote = dvot
devoted = dvotd
devotes = dvots
devoting = dvotg
devotion = dvoz
dexterity = dxtrt
dexterous = dxtrus
diagnose = dignos
diagnosis = dignss
diagnostic = dignstc
diagram = digrm
diagrams = digrms
dialog = dilg
dialogs = dilgs
diameter = dimtr
diamond = dimnd
diamonds = dimnds
diaper = dipr
diapers = diprs
dictate = dctt
dictated = dcttd
dictates = dctts
dictating = dcttg
dictation = dctz
dictator = dcttr
dictionary = dczr
did = dd
didn't = ddnt
die = di
died = did
dies = dis
diet = diet
dietary = ditar
diets = diets
differ = dfr
difference = dfrnc
differences = dfrncs
different = dfrnt
differently = dfrntl
differs = dfrs
difficult = dfcl
difficulties = dfclts
difficulty = dfclt
diffuse = dfus
dig = dig
digest = dijst
digging = digg
digital = djtl
dignified = dgnfid
dignity = dgnt
digs = dgs
diligence = dljnc
diligent = dljnt
diligently = dljntl
diluted = dlutd
dim = dim
dimension = dmnz
dimensions = dmnzs
diminish = dmns
diminished = dmnsd
diminishes = dmnss
diminishing = dmnsg
dimmed = dimd
dimming = dimg
dims = dims
dining = ding
dinner = dnr
dip = dp
diplomacy = dplmc
dipped = dpd
dipping = dpg
dips = dps
dire = dir
direct = drct
directed = drctd
directing = drctg
direction = drcz
directions = drczs
directive = drctv
directly = drctl
director = drctr
directors = drctrs
directory = drctre
directs = drcts
dirt = drt
dirty = drte
disabilities = dsabts
disability = dsabt
disable = dsab
disabled = dsabd
disables = dsabs
disadvantage = dsvntj
disadvantages = dsavntjs
disagree = dsgre
disagreement = dsgrem
disappear = dsper
disappearance = dspernc
disappeared = dsprd
disappearing = dsperg
disappears = dspers
disappoint = dspnt
disappointed = dspntd
disappointing = dspntg
disappointment = dspntm
disappointments = dspntms
disappoints = dspnts
disapprove = dsprv
disapproves = dsprvs
disapproving = dsprvg
disarray = dsra
disaster = dsstr
disasters = dsstrs
discard = dscrd
discarded = dscrdd
discern = dscrn
discharge = dscrj
discharged = dscrjd
discharges = dscrjs
discipline = dspln
disciplined = dsplnd
disclaim = dsclam
disclaimer = dsclamr
discomfort = dscfrt
disconnect = dscnct
discontent = dsctnt
discontented = dsctntd
discord = dscord
discordant = dscordnt
discount = dscont
discourage = dscurj
discouraged = dscurjd
discouragement = dscurjm
discourages = dscurjs
discouraging = dscurjg
discover = dscv
discovered = dscvd
discoveries = dscvrs
discovering = dscvg
discovers = dscvs
discovery = dscvr
discredit = dscrdt
discreet = dscret
discrete = dscrt
discretion = dscrz
discriminate = dscrmnt
discriminating = dscrmntg
discuss = dscs
discussed = dscsd
discusses = dscss
discussion = dscz
discussions = dsczs
disdain = dsdan
disease = dses
diseases = dsess
disengage = dsngj
disguise = dsgiz
disguised = dsgizd
disgust = dsgst
disgusted = dsgstd
disgusting = dsgstg
dish = dish
dishes = dishs
dishonest = dishns
dishonesty = dshnst
disillusioned = dsilzd
disk = disk
disks = disks
dislike = dslik
dislikes = dsliks
disloyal = dslyl
dismal = dsml
dismantle = dsmntl
dismantled = dsmntld
dismantles = dsmntls
dismantling = dsmntlg
dismay = dsma
dismayed = dsmad
dismays = dsmas
dismiss = dsms
dismissed = dsmsd
disorder = dsord
disorganization = dsorgnzz
disorganized = dsorgnzd
dispel = dspl
dispelled = dspld
dispense = dspns
displace = dsplc
display = dspla
displayed = dsplad
displaying = dsplag
displays = dsplas
disposable = dsposb
disposal = dsposl
dispose = dspos
disposition = dspoz
dispute = dsput
disregard = dsrgrd
disrupt = dsrpt
disrupted = dsrptd
disruption = dsrpz
disruptive = dsrptv
disrupts = dsrps
dissatisfaction = dstsfcz
dissatisfied = dsstsfid
dissect = dsct
dissected = dsctd
dissipate = dspat
dissipated = dspatd
dissipates = dspats
dissolve = dsolv
distance = dstnc
distances = dstncs
distant = dstnt
distinct = dstnct
distinction = dstncz
distinctions = dstnczs
distinctive = dstnctv
distinctly = dstnctl
distinguish = dstngs
distinguished = dstgsd
distortions = dstrzs
distract = dstrct
distracted = dstrctd
distracting = dstrctg
distraction = dstrcz
distractions = dstrczs
distracts = dstrcts
distraught = dstrut
distress = dstrs
distressed = dstrsd
distresses = dstrss
distressing = dstrsg
distribute = dstrbt
distributed = dstrbtd
distributes = dstrbts
distributing = dstrbtg
distribution = dstrbz
district = dstrict
districts = dstricts
distrust = dstrst
disturb = dstrb
disturbance = dstrbnc
disturbed = dstrbd
disturbing = dstrbg
disturbs = dstrbs
ditch = dtc
dive = div
dived = divd
diverse = dvrs
diversion = dvrz
diversions = dvrzs
diversity = dvrst
divert = dvrt
diverted = dvrtd
dives = divs
divide = dvid
divided = dvidd
dividend = dvdnd
dividends = dvdnds
divider = dvidr
dividers = dvidrs
divides = dvids
dividing = dvidg
divine = dvin
diving = divg
division = dvz
divisions = dvzs
divisive = dvisv
divorce = dvrc
divorced = dvrcd
divorces = dvrcs
divulge = dvlj
do = d
docile = dcil
doctor = dctr
doctors = dctrs
doctrine = dctrn
doctrines = dctrns
document = dcum
documentary = dcumr
documentation = dcumz
documented = dcumd
documenting = dcumg
documents = dcums
does = ds
doesn't = dsnt
dog = dog
dogmatic = dgmtc
dogs = dogs
doing = dg
doll = dol
dollar = dlr
dollars = dlrs
dolls = dols
domain = dman
dominance = dmnnc
dominant = dmnnt
dominate = dmnt
dominates = dmnts
dominating = dmntg
don't = dnt
donate = dnat
donation = dnaz
donations = dnazs
done = dn
doom = dom
door = dor
doors = dors
dormant = drmnt
dot = dot
dots = dots
dotted = dotd
double = dbl
doubled = dbld
doubling = dblg
doubt = dout
doubted = doutd
doubtful = doutf
doubting = doutg
doubts = douts
down = dw
downfall = dwfl
downhill = dwhl
downright = dwrt
downs = dws
downside = dwsid
downtown = dwtwn
downturn = dwtrn
dozen = dz
dozens = dzs
drab = drb
draft = drf
drafts = drfs
drag = drg
dragged = drgd
dragging = drgg
dragon = drgn
drags = drgs
drain = dran
drainage = dranj
drained = drand
draining = drang
drains = drans
drama = drma
dramatic = drmtc
dramatically = drmtcl
drank = drank
drastic = drstc
draw = drw
drawback = drwbk
drawbacks = drwbks
drawing = drwg
drawings = drwgs
drawn = drwn
draws = drws
dread = dred
dreaded = dredd
dream = drem
dreamed = dremd
dreaming = dremg
dreams = drems
dreary = drer
dredge = drj
dress = drs
dressed = drsd
dresses = drss
dressing = drsg
drew = dru
dribble = drbl
dried = drid
dries = dris
drift = drft
drifted = drftd
drifting = drftg
drifts = drfts
drill = drl
drills = drls
drink = drnk
drinking = drnkg
drinks = drnks
drip = drp
dripped = drpd
dripping = drpg
drips = drps
drive = drv
drivel = drvl
driven = drvn
driver = drvr
driver's = drvrss
drivers = drvrs
drives = drvs
driving = drvg
drizzle = drzl
drop = drop
dropped = dropd
dropping = dropg
drops = drops
drove = drov
drudgery = drjr
drug = drug
drugged = drugd
drugs = drugs
drum = drm
drums = drms
drunk = drunk
dry = dri
drying = drig
duck = dk
ducks = duks
due = due
dues = dues
dug = dug
dull = dul
dumb = dmb
dump = dump
dumped = dumpd
dumping = dumpg
dumps = dumps
duplicate = dplct
duplicated = dplctd
durable = durb
duration = durz
during = durg
dust = dst
dusted = dstd
dusting = dstg
dusts = dsts
duties = duts
duty = dut
dwell = dwl
dwelling = dwlg
dwindle = dwndl
dying = dyg
dynamic = dnmc
dynamics = dnmcs
dynamite = dnmit
each = ec
eager = egr
eagerly = egrl
eagle = egl
ear = er
earlier = erlr
earliest = erlst
early = erl
earn = ern
earned = ernd
earnest = ernst
earning = erng
earnings = erngs
ears = ers
earth = ert
earthquake = ertck
earthquakes = ertcks
earthshaking = ertsakg
ease = es
eases = ess
easier = ezr
easiest = ezst
easily = ezl
east = est
eastern = estrn
easy = ez
eat = et
eaten = etn
eating = etg
eats = ets
eccentric = ecntrc
echo = eco
eclipses = ecpss
economic = ecnmc
economical = ecnmcl
economics = ecnmcs
economy = ecnm
ecstasies = xstcs
ecstasy = xstc
ecstatic = xsttc
edge = ej
edged = ejd
edges = ejs
edging = ejg
edifice = edfc
edifices = edfcs
edifies = edfis
edify = edfi
edifying = edfig
edit = edt
edited = edtd
editing = edtg
edition = edz
editions = edzs
editor = edtr
editors = edtrs
educate = edct
educated = edctd
education = edcz
educational = edczl
effect = efct
effective = efctv
effectively = efctvl
effectiveness = efctvns
effects = efcts
efficacy = efcc
efficiencies = efcncs
efficiency = efcnc
efficient = efcnt
efficiently = efcntl
effort = efrt
effortless = efrtls
effortlessly = efrtlsl
effortlessness = efrtlsns
efforts = efrts
egg = eg
egging = egg
eggs = egs
eight = eit
eighty = eite
either = etr
elaborate = elbrt
elaboration = elbrz
elapsed = elpsd
elect = elct
elected = elctd
election = elcz
elections = elczs
electric = elctrc
electrical = elctrcl
electrically = elctrcll
electricity = elctrct
electron = elctrn
electronic = elctrnc
electronics = elctrncs
electrons = elctrns
elects = elcts
elegance = elgnc
elegant = elgnt
elegantly = elgntl
element = elm
elemental = elml
elementary = elmntr
elements = elms
elevate = elvt
elevated = elvtd
elevates = elvts
elevating = elvtg
eleven = elvn
eligibililty = eljbt
eligible = eljb
eliminate = elmnt
eliminated = elmntd
eliminating = elmntg
elite = elit
ellipse = elps
ellipses = elpss
eloquence = elcnc
eloquent = elocnt
eloquently = elcntl
else = els
else's = elss
elsewhere = elswr
elucidate = elucdt
elude = elud
eluded = eludd
eludes = eluds
eluding = eludg
elusive = elusv
embark = mbrk
embarked = mbrkd
embarking = mbrkg
embarks = mbrks
embarrass = mbars
embarrassed = mbarsd
embarrassing = mbarsg
embarrassment = mbarsm
embellish = mbls
embellishes = mblss
embellishment = mblsm
embitter = mbtr
embittered = mbtrd
emblem = mblm
emblems = mblms
embodies = mbods
embody = mbod
embrace = mbrac
embraced = mbracd
embraces = mbracs
embracing = mbracg
embryo = mbryo
embryos = mbryos
emerge = emrj
emerged = emrjd
emergency = emrjnc
emerges = emrjs
emerging = emrjg
eminently = mnntl
emotion = emoz
emotional = emozl
emotionally = emozll
emotionless = emozls
emotions = emozs
empathic = mpatc
empathy = mpat
emphasis = mfss
emphasize = mfsz
emphasized = mfszd
emphasizing = mfszg
empire = mpir
empires = mpirs
employ = mply
employed = mplyd
employee = emploe
employees = mpoes
employer = mplyr
employers = mplyrs
employment = mplym
employs = mplys
emptied = emtd
empties = emts
emptiness = emtns
empty = emt
emptying = emtg
emulate = emult
emulated = emultd
emulates = emults
enable = nab
enabled = nabd
enables = nabs
enabling = nabg
enchant = encnt
enchanting = encntg
enclose = nclos
enclosed = nclsd
encloses = ncloss
enclosing = nclosg
encompass = ncmps
encompassing = ncmpsg
encounter = ncontr
encountered = ncontrd
encounters = ncontrs
encourage = ncurj
encouraged = ncurjd
encouragement = ncurjm
encourages = ncurjs
encouraging = ncurjg
encumbrances = ncmbrnc
end = end
endear = nder
endearment = nderm
endeavor = ndvr
endeavors = ndvrs
ended = endd
ending = endg
endings = endgs
endless = endls
endorsement = ndrsm
endowed = ndowd
endpoint = endpnt
endpoints = endpnts
ends = ends
endurance = ndurnc
endure = ndur
endured = ndurd
endures = ndurs
enduring = ndurg
enemies = enms
enemy = enm
energetic = nrgtc
energetically = nrgtcl
energies = nrgs
energy = nrg
enforce = nfrc
engage = ngj
engaged = ngjd
engine = ngn
engineer = njnr
engineered = njnrd
engineering = njnrg
engineers = njnrs
engines = njns
England = eglnd
English = engl
enhance = nhnc
enhanced = nhncd
enhancement = nhncm
enhancements = nhncms
enhances = nhncs
enhancing = nhncg
enjoy = nj
enjoyable = njb
enjoyed = njd
enjoying = njg
enjoyment = njm
enjoys = njs
enlarge = nlrj
enlarging = nlrjg
enlighten = nlitn
enlightened = nlitnd
enlist = nlist
enormous = enrms
enough = eno
enrich = nrc
entail = ntal
entailed = ntald
entails = ntals
enter = ntr
entered = ntrd
entering = ntrg
enterprise = ntrprz
enters = ntrs
entertain = ntrtan
entertained = ntrtand
entertaining = ntrtang
entertainment = ntrtanm
entertains = ntrtans
enthusiasm = ntussm
enthusiastic = ntustc
entice = ntic
enticed = nticd
entices = ntics
enticing = nticg
entire = ntir
entirely = ntirl
entirety = ntirt
entities = ntts
entitled = ntitld
entitlement = ntitlm
entity = entt
entrance = ntrnc
entrances = ntrncs
entries = ntres
entrust = entrst
entrusted = ntrustd
entrusts = entrsts
entry = ntre
enumerate = enmrt
enumeration = enmrz
envelop = nvlp
envelope = nvlop
enveloped = nvlpd
envelopes = nvlops
envelops = nvlps
enviable = nvib
envied = envd
envies = envs
envious = nvus
environment = nvrnm
environmental = nvrnml
envision = nvz
envisioned = nvzd
envisions = nvzs
envy = env
ephemeral = efmrl
episode = epsod
episodes = epsods
episodic = epsodc
equal = ecl
equality = eclt
equally = ecll
equals = ecls
equate = ecat
equates = ecats
equation = ecaz
equations = ecazs
equator = ecatr
equilibrium = eclbrm
equip = ecp
equipment = ecpm
equipped = ecpd
equipping = ecpg
equivalence = ecvlnc
equivalent = ecvlnt
equivalents = ecvlnts
era = era
eradicate = erdct
eradicated = erdctd
eradicates = erdcs
eradicating = erdctg
erase = eras
erased = erasd
erases = erass
erasing = erasg
erect = erct
erected = erctd
erecting = erctg
erection = ercz
erects = ercts
ergonomic = ergnmc
erode = erod
eroded = erodd
erodes = erods
eroding = erodg
erosion = eroz
errands = ernds
erratic = eratc
erred = errd
erroneous = eronus
error = err
errors = errs
erupt = erpt
erupted = erptd
erupting = erptg
erupts = erpts
escape = escp
escaped = escpd
escapes = escps
escaping = escpg
especially = espcll
essay = esa
essays = esas
essence = esnc
essential = esnsl
essentially = esnsll
essentials = esnsls
establish = estbls
established = estblsd
establishes = estblss
establishing = estblsg
establishment = estblsm
estate = estat
estates = estats
esteem = estem
esteemed = estemd
esteems = estems
estimate = estmt
estimated = estmtd
estimates = estmts
estimation = estmz
etc = etc
eternal = etrnl
eternity = etrnt
ethic = etic
ethical = eticl
ethically = eticll
ethics = etics
Europe = eurp
European = uropn
evade = evad
evaded = evadd
evades = evads
evading = evadg
evaluate = evlut
evaluated = evlutd
evaluating = evlutg
evaluation = evluz
evaporate = evprt
evaporated = evprtd
evaporates = evprts
evaporating = evprtg
even = evn
evening = evng
evenings = evngs
evenly = evnl
event = evnt
events = evnts
eventually = evntll
ever = ev
every = evr
everybody = evbd
everyday = evda
everyone = evon
everything = evg
everywhere = evwr
evidence = evdnc
evident = evdnt
evil = evl
evoke = evok
evokes = evoks
evoking = evokg
evolution = evolz
evolutionary = evluznr
evolve = evlv
evolved = evlvd
evolves = evlvs
evolving = evlvg
exact = xct
exactly = xctl
exaggerate = xgrt
exaggerated = xgrtd
exaggerating = xgrtg
exaggeration = xgrz
exam = xmexam = xm
examination = xmnz
examinations = xmnzs
examine = xmn
examined = xmnd
examining = xmng
example = xmp
examples = xmps
exams = xms
exceed = xced
exceeded = xcedd
exceeding = xcedg
exceeds = xceds
excel = xcl
excelled = xcld
excellence = xclnc
excellent = xclnt
excellently = xclntl
excels = xcls
except = xcpt
exception = xcpz
exceptional = xcpzl
excess = xcs
excesses = xcss
excessive = xcsv
excessively = xcsvl
exchange = xcnj
exchanged = xcnjd
exchanges = xcnjs
exchanging = xcnjg
excite = xcit
excited = xcitd
excitement = xcitm
excites = xcits
exciting = xcitg
exclaimed = xclamd
exclude = xclud
excluded = xcludd
exclusion = xcluz
exclusive = xclusv
exclusively = xclusvl
excruciating = xcruztg
excuse = xcus
excused = xcusd
excuses = xcuss
excusing = xcusg
execute = xcut
executed = xcutd
executing = xcutg
execution = xcuz
executive = xcutv
executives = xcutvs
exercise = xrcz
exercised = xrczd
exercises = xrczs
exercising = xrczg
exert = xrt
exerted = xrtd
exerting = xrtg
exertion = xrz
exertions = xrzs
exerts = xrts
exhaust = xust
exhausted = xhstd
exhausting = xhstg
exhaustion = xustz
exhausts = xhsts
exhibit = xbt
exhibited = xbtd
exhibits = xbts
exhilarating = xlrtg
exhilaration = xlrz
exile = xil
exiled = xild
exiles = xils
exist = xst
existed = xstd
existence = xstnc
existing = xstg
exists = xsts
exit = xit
exited = xitd
exiting = xitg
exits = xits
exotic = xotc
expand = xpnd
expanded = xpndd
expanding = xpndg
expands = xpnds
expanse = xpans
expansion = xpnz
expansions = xpnzs
expansive = xpansv
expect = xpct
expectancy = xpctcnc
expectation = xpctz
expectations = xpctzs
expected = xpctd
expecting = xpctg
expects = xpcts
expedition = xpdz
expel = xpl
expelled = xpld
expelling = xplg
expels = xpls
expend = xpend
expended = xpendd
expending = xpendg
expenditure = xpndtr
expends = xpends
expense = xpns
expenses = xpnss
expensive = xpnsv
experience = xprnc
experienced = xprncd
experiences = xprncs
experiencing = xprncg
experiment = xprm
experimental = xprml
experimentally = xprmll
experimentation = xprmz
experimenting = xprmg
experiments = xprms
expert = xprt
expertise = xprtz
expertly = xprtl
experts = xprts
expire = xpir
expired = xpird
expires = xpirs
expiring = xpirg
explain = xplan
explained = xpland
explaining = xplang
explains = xplans
explanation = xplnz
explanations = xplnzs
explanatory = xplntr
explicit = xplct
explicitly = xplctl
explode = xplod
exploded = xplodd
explodes = xplods
exploding = xplodg
exploit = xplyt
exploitation = xplytz
exploited = xplytd
exploiting = xplytg
exploits = xplyts
exploration = xplrz
explore = xplr
explored = xplrd
explorer = xplrr
explorers = xplrrs
explores = xplrs
exploring = xplrg
explosion = xploz
explosions = xplozs
explosive = xplosv
explosively = xplosvl
export = xport
exported = xportd
exporting = xportg
exports = xports
expose = xpos
exposed = xposd
exposes = xposs
exposing = xposg
exposition = xposz
exposure = xposr
expound = xpond
expounding = xpondg
expounds = xponds
express = xprs
expressed = xprsd
expresses = xprss
expressing = xprsg
expression = xprsz
expressions = xprszs
expressive = xprsv
exquisite = xcst
extend = xtnd
extended = xtndd
extending = xtndg
extends = xtnds
extension = xtnz
extensions = xtnzs
extensive = xtnsv
extensively = xtnsvl
extent = xtnt
exterior = etrr
exteriors = etrrs
external = xtrnl
externally = xtrnll
extinguish = xtngs
extinguished = xtngsd
extinguishing = xtngsg
extra = xtr
extract = xtrct
extracted = xtrctd
extracting = xtrctg
extraction = xtrctz
extracts = xtrcts
extraneous = xtrnus
extraordinary = xordnr
extras = xtrs
extravagance = xtrvgnc
extravagances = xtrvgncs
extravagant = xtrvgnt
extravagantly = xtrvgntl
extreme = xtrem
extremely = xtreml
extremes = xtrems
exude = xud
exuded = xudd
exudes = xuds
exuding = xudg
eye = ey
eyes = eys
fabric = fbrc
fabrication = fbrcz
fabrics = fbrcs
fabulous = fbulus
face = fac
faced = facd
faces = facs
facet = fcet
faceted = fcetd
facets = fcets
facial = facl
facilities = fcilts
facility = fcilt
facing = facg
fact = fct
factor = fctr
factories = fctors
factors = fctrs
factory = fctor
facts = fcts
faculties = fclts
faculty = fclt
fade = fad
faded = fadd
fades = fads
fading = fadg
fail = fal
failed = fald
failing = falg
fails = fals
failure = falr
failures = falrs
faint = fant
fainted = fantd
fainting = fantg
faints = fants
fair = far
fairly = farl
fairness = farns
faith = fait
faithful = faitf
faithfully = faitfl
faiths = faits
fake = fak
faker = fakr
fakery = fakre
fall = fl
fallen = fln
falling = flg
falls = fls
false = false
fame = fam
familiar = fmlr
familiarity = fmlrt
families = fmls
family = fml
famous = famus
fancy = fanc
fantasies = fntss
fantastic = fntstc
fantasy = fnts
far = fr
farewell = frwl
farm = farm
farmer = farmr
farmers = farmrs
farming = farmg
farms = farms
farther = frr
farthermost = frrmo
farthest = frtst
fascinate = fsnt
fascinated = fsntd
fascinates = fsnts
fascinating = fsntg
fascination = fsnz
fashion = fz
fashionable = fzb
fashioned = fzd
fashioning = fzg
fast = fst
fasten = fasn
fastened = fasnd
fasteners = fasnrs
faster = fstr
fastest = fstst
fat = fat
fatal = fatl
fatally = fatll
fate = fate
fateful = fatf
fates = fats
father = fatr
fathers = fatrs
fathom = fatm
fathoms = fatms
fatigue = ftig
fatigued = ftigd
fatigues = ftigs
fatiguing = ftigg
fault = falt
faults = falts
faulty = falte
favor = favr
favorable = favrb
favored = favrd
favoring = favrg
favorite = fvrt
favors = favrs
faze = faz
fazed = fazd
fazing = fazg
fear = fer
feared = ferd
fearful = ferf
fearing = ferg
fearless = ferls
fearlessly = ferlsl
fears = fers
feasibility = fesbt
feast = fest
feat = feat
feather = ftr
feathers = ftrs
feature = fetur
featured = feturd
features = feturs
February = feb
fed = fd
federal = fdrl
fee = fe
feeble = febl
feebly = febll
feed = fed
feedback = fdbk
feeding = fedg
feeds = feds
feel = fel
feeling = felg
feelings = felgs
feels = fels
fees = fes
feet = fet
fell = fell
fellow = felo
fellows = felos
felon = felon
felonious = felonus
felony = felone
felt = felt
female = fmal
females = fmals
fence = fnc
fences = fncs
fencing = fncg
fend = fend
fern = frn
ferocious = frocs
ferocity = froct
ferry = fere
fertile = frtl
fertility = frtlt
fertilizing = frtlzg
fervor = frvr
festival = fstvl
festivals = fstvls
fever = fevr
feverish = fevrs
few = fw
fewer = fwr
fewest = fwst
fiber = fibr
fibers = fibrs
fiction = fcz
fictions = fczs
fiddling = fdlg
field = feld
fields = felds
fierce = firc
fiercely = fercl
fifth = fift
fifty = ffte
fight = fit
fighting = fitg
fights = fits
figment = fgm
figments = fgms
figure = fgr
figured = fgrd
figures = fgrs
figuring = fgrg
file = fil
filed = fild
files = fils
filing = filg
fill = fll
filled = flld
filling = fllg
fills = flls
film = flm
filmed = flmd
filming = flmg
films = flms
filter = fltr
filtered = fltrd
filtering = fltrg
filters = fltrs
final = finl
finally = finll
finance = finnc
finances = finncs
financial = finncl
financially = finncll
financing = finncg
find = fnd
finding = fndg
finds = fnds
fine = fin
fines = fines
finest = finst
finger = fngr
fingers = fngrs
fingertips = fngrtps
finish = fns
finished = fnsd
finishes = fnss
finishing = fnsg
fins = fins
fire = fir
fired = fird
fireplace = firplc
fires = firs
firm = firm
firmly = firml
firms = firms
first = frst
fiscal = fiscl
fiscally = fiscll
fish = fs
fishing = fsg
fist = fist
fit = ft
fitful = ftf
fits = fts
fitted = ftd
fitting = ftg
five = fiv
fix = fx
fixed = fxd
fixes = fxs
fixing = fxg
fixture = fxtr
flag = flag
flagging = flgg
flags = flgs
flail = flal
flailing = flalg
flair = flair
flame = flam
flames = flams
flare = flar
flared = flard
flares = flars
flaring = flarg
flash = flas
flashes = flss
flashing = flasg
flat = flt
flatten = fltn
flattened = fltnd
flattening = fltng
flattens = fltns
flaunt = flnt
flaunting = flntg
flavor = flavr
flavored = flavrd
flavors = flavrs
flaw = flw
flawed = flwd
flawless = flwls
flawlessly = flwlsl
flaws = flws
flea = fle
fled = fled
fleeing = fleg
fleet = flet
fleeting = fletg
flesh = fles
flew = flu
flex = flx
flexes = flxs
flexibility = flxbt
flexible = flxb
flexing = flxg
flick = flik
flicker = flkr
flickering = flkrg
flies = flis
flight = flit
flights = flits
flimsy = flmse
flinch = flnc
flinched = flncd
flinches = flncs
flinching = flncg
flip = flp
flipped = flpd
flipping = flpg
flips = flps
float = flot
floated = flotd
floating = flotg
floats = flots
flood = flood
floodgates = flodgts
flooding = flodg
floods = flods
floor = flr
floors = flrs
flop = flop
flopped = flopd
flopping = flopg
floppy = flope
flops = flops
flour = flor
flourish = flurs
flourished = flursd
flourishes = flurss
flourishing = flursg
flow = flo
flowed = flod
flower = flwr
flowering = flwrg
flowers = flwrs
flowing = flog
flown = flon
flows = flos
fluctuate = flctut
fluctuated = flctutd
fluctuating = flctutg
fluctuation = flctuz
fluctuations = flctuzs
fluent = flunt
fluently = fluntl
fluff = flf
fluffy = flfe
fluid = flud
fluids = fluds
fluorescent = flurcnt
flurry = flur
flush = flus
fluster = flstr
flustered = flstrd
flutter = flutr
fluttering = flutrg
fly = fli
flying = flig
focus = focs
focused = focsd
focuses = focss
focusing = focsg
fog = fog
foggy = foge
foil = fyl
foiling = fylg
foils = fyls
foist = fyst
fold = fld
folded = fldd
folders = fldrs
folding = fldg
folds = flds
foliage = folj
folk = flk
folklore = flklr
folks = flks
follies = foles
follow = folo
followed = folod
following = folog
follows = folos
folly = fole
fond = fonnd
fondest = fondst
fondly = fondl
food = fod
foods = fods
fool = fol
fooled = fold
foolhardy = folhrd
fooling = folg
foolish = folis
foolishness = folsns
foolproof = folprf
fools = fols
foot = fot
footing = fotg
for = f
forbid = fbd
forbidden = fbdn
forbidding = fbdg
forbids = fbds
force = frc
forced = frcd
forceful = frcf
forcefully = frcfl
forces = frcs
forcing = frcg
forecast = fcst
forecasting = fcstg
forefront = ffrnt
foreground = fgrnd
forehead = fhed
foreign = forn
foremost = fmo
foresaw = fsw
foresee = fse
foreseeable = fseb
foreseen = fsen
foresight = fsit
forest = forst
forested = forstd
forests = forsts
forethought = ftot
forever = fev
forgave = fgav
forge = frj
forged = frgd
forget = fgt
forgets = fgts
forgetting = fgtg
forging = frjg
forgive = fgv
forgiveness = fgvns
forgiving = fgvg
forgot = fgot
forgotten = fgtn
fork = frk
forlorn = frlrn
form = frm
formal = frml
format = frmt
formation = frmz
formative = frmtv
formed = frmd
former = frmr
forming = frmg
forms = frms
formula = frmla
formulas = frmlas
formulate = frmlt
formulated = frmultd
formulating = frmltg
formulation = frmulz
fort = fort
forth = frt
fortitude = frttud
forts = forts
fortunate = frtnt
fortunately = ftuntl
fortune = ftun
forty = forte
forum = frum
forward = fwd
forwarded = fwdd
foster = fostr
fostering = fostrg
fosters = fostrs
fought = fout
foul = foul
fouled = fould
fouling = foulg
found = fond
foundation = fondz
foundations = fondzs
founded = fondd
fountain = fontn
four = for
fourth = fourt
fox = fox
fraction = frcz
fractions = frczs
fractured = frctrd
fragile = frjl
fragment = frgm
fragmented = frgmd
fragments = frgms
frail = fral
frailty = fralt
frame = fram
framed = framd
frames = frams
framework = framwrk
framing = framg
France = frnc
frank = frnk
frankly = frnkl
frantic = frntc
frantically = frntcl
fraught = fraut
fray = fra
frazzle = frzl
frazzled = frzld
freak = frek
freaking = frekg
freaks = freks
free = fre
freedom = fredm
freeing = freg
freely = frel
frees = frees
freeze = frez
freezes = frezs
freezing = frezg
freight = frat
freighter = fratr
French = frenc
frenzies = frnzs
frenzy = frnz
frequencies = frcncs
frequency = frcnc
frequent = frcnt
frequently = frcntl
fresh = fres
freshly = fresl
fret = fret
fretful = fretf
fretting = fretg
friction = fricz
Friday = fri
friend = frnd
friendly = frndl
friends = frnds
friendship = frndzp
friendships = frndzps
fright = frit
frighten = fritn
frightened = fritnd
frightening = fritng
frightens = fritns
fritter = frtr
fritters = frtrs
frivolity = frvlt
frivolous = frvlus
frog = frog
frogs = frogs
from = fm
front = frnt
frontier = frntr
frontiers = frntrs
fronts = frnts
frosting = frstg
frozen = frzn
frugal = frugl
frugality = fruglt
frugally = frugll
fruit = frut
fruitful = frutf
fruition = fruz
fruits = fruts
frustrate = frstrt
frustrated = frstrtd
frustrates = frstrts
frustrating = frstrtg
frustration = frstrz
frustrations = frstrzs
fry = fry
fuel = fuel
fulfill = flfl
fulfilled = flfld
fulfilling = flflg
fulfillment = flflm
fulfills = flfls
full = ful
fullest = fulst
fullness = fulns
fully = full
fumble = fmbl
fun = fn
function = fncz
functional = fnczl
functionally = fnczll
functioning = fnczg
functions = fnczs
fund = fund
fundamental = fndml
fundamentally = fndmll
fundamentals = fndmls
funds = funds
funeral = funrl
funerals = funrls
fungi = fnji
fungus = fgus
funk = fnk
funny = fne
furies = furs
furious = furus
furl = frl
furnish = furns
furnished = furnsd
furnishes = furnss
furniture = frntur
further = furr
furthermore = furmr
fury = fury
fuss = fuss
fussed = fusd
fussing = fusg
futile = futl
futility = futlt
future = futr
futures = futrs
fuzz = fzz
fuzzy = fzze
gadget = gjt
gadgets = gjts
gain = gan
gained = gand
gaining = gang
gains = gans
gallon = gln
gallons = glns
gamble = gmbl
gambled = gmbld
gambles = gmbls
gambling = gmblg
game = gam
games = gams
gaming = gamg
gang = gng
gangs = gngs
gap = gp
gapping = gpg
gaps = gps
garage = grj
garages = grjs
garbage = grbj
garden = grdn
gardening = grdng
gardens = grdns
garment = garm
garments = garms
gas = gas
gases = gss
gasoline = gsln
gasp = gsp
gasped = gspd
gasping = gspg
gasps = gsps
gate = gat
gates = gats
gather = gtr
gathered = gtrd
gathering = gtrg
gathers = gtrs
gauge = gj
gauges = gjs
gave = gav
gaze = gaz
gazed = gazd
gazes = gazs
gear = ger
geared = gerd
gearing = gerg
gears = gers
geese = gees
gel = gl
gem = gem
gems = gems
gene = gen
general = gnrl
generalize = gnrlz
generally = gnrll
generals = gnrls
generate = gnrt
generated = gnrtd
generates = gnrts
generating = gnrtg
generation = gnrz
generations = gnrzs
generosity = gnrst
generous = gnrus
genes = gens
genetic = gntc
genius = gnus
gentle = gntl
gentleman = gntlm
gentlemen = gntlmn
gentler = gntlr
gentlest = gntlst
gently = gntll
genuine = gnin
genuinely = gninl
German = grmn
gesture = gstur
gestures = gsturs
get = gt
gets = gts
getting = gtg
ghost = gost
ghosts = gosts
giant = gint
giants = gints
gift = gft
gifts = gfts
gigantic = gigntc
gimmick = gmk
gimmicks = gmks
girl = grl
girls = grls
give = gv
given = gvn
gives = gvs
giving = gvg
glad = gld
gladly = gldl
glamorous = glmrus
glance = glnc
glanced = glncd
glancing = glncg
glare = glar
glared = glard
glaring = glarg
glass = gls
glasses = glss
gleam = glem
gleams = glems
glee = gle
gleeful = glef
gleefully = glefl
glib = glb
glibly = glbl
glide = glid
glided = glidd
glides = glids
gliding = glidg
glimmer = glmr
glimmering = glmrg
glimmers = glmrs
glimpse = glms
glimpsed = glmsd
glimpses = glmss
glitch = glc
glitches = glcs
global = globl
globe = glob
gloom = glom
gloomy = glme
glories = glors
glorious = glrus
glory = glor
gloss = glos
glossy = glose
glow = glo
glowed = glod
glowing = glog
glue = glu
glued = gludo
glues = glus
gluing = glug
gnaw = gnw
gnawed = gnwd
gnawing = gnwg
gnaws = gnws
go = g
goal = gol
goals = gols
goat = goat
goats = goats
god = god
gods = gods
goes = gs
going = gg
gold = gold
golden = goldn
gone = gn
good = gd
goodness = gdns
goods = gds
goose = gos
gorgeous = grjus
got = got
gotten = gotn
govern = gvrn
governed = gvrnd
governing = gvrng
government = gvr
governments = gvts
governor = gvrnr
governors = gvrnrs
governs = gvrns
grab = grb
grabbed = grbd
grabbing = grbg
grabs = grbs
grace = grac
graceful = gracf
gracefully = gracfl
graces = gracs
gracious = gracus
graciously = gracusl
grade = grad
grades = grads
gradual = grdl
gradually = grdll
graduate = grdut
graduated = grdutd
grail = gral
grails = grals
grain = gran
grains = grans
gram = gm
grammar = grmr
grams = gms
grand = grnd
grandfather = grndfatr
grandiose = grndos
grandmother = grndmotr
grant = grnt
granted = grntd
grants = grnts
grape = grap
grapes = graps
graph = graf
graphic = grfc
graphics = grfcs
grasp = grsp
grasped = grspd
grasping = grspg
grasps = grsps
grass = grs
grasses = grss
grateful = gratf
gratefully = gratfl
gratification = grtfcz
gratify = grtfi
gratifying = grtfig
gratitude = grttud
grave = grav
gravely = gravl
graves = gravs
gravity = grvt
gray = gra
graze = graz
grazing = grazg
grease = gres
greased = gresd
greases = gresis
greasing = gresg
great = gr
greater = grr
greatest = grst
greatly = grtl
greatness = grns
greed = gred
greedy = grede
Greek = grek
green = gren
greet = gret
greeted = gretd
greeting = gretg
greetings = gretgs
grew = gru
grid = grd
grids = grds
grief = gref
grieve = grev
grieves = grevs
grieving = grevg
grim = grim
grimly = grml
grip = grp
gripe = grip
griped = gripd
gripes = grips
griping = gripg
gripping = grpg
grips = grps
gritting = grtg
groove = grov
grooved = grovd
grooves = grovs
gross = gross
ground = grond
grounded = grondd
grounds = gronds
groundwork = grndwrk
group = grup
grouped = grupd
grouping = grupg
groups = grups
grove = grv
groves = grvs
grow = gro
growing = grog
grown = gron
grows = gros
growth = grot
guarantee = grnte
guarantees = grntes
guard = gard
guarded = gardd
guardian = gardn
guardians = gardns
guarding = gardg
guards = gards
guess = ges
guessed = gesd
guesses = gess
guessing = gesg
guest = gst
guests = gsts
guidance = gidnc
guide = gid
guided = gidd
guideline = gidlin
guidelines = gidlins
guides = gids
guiding = gidg
guilt = glt
guilty = gilt
guitar = gtar
gulf = glf
gulfs = glfs
gullible = gulb
gulp = glp
gulped = glpd
gulps = glps
gun = gun
gunning = gung
guns = gns
gurgle = grgl
gurgling = grglg
gush = gus
gushed = gusdo
gushes = guss
gushing = gusg
gypsies = gpses
gypsy = gpse
habit = hbt
habits = hbts
had = hd
hadn't = hdnt
hail = hal
hailed = hald
hailing = halg
hails = hals
hair = hair
hairs = hairs
half = hf
halfway = hfwa
hall = hall
hallmark = hlmrk
halt = hlt
halted = hltd
halves = hvs
hammer = hmr
hammered = hmrd
hammering = hmrg
hammers = hmrs
hamper = hmpr
hampered = hmprd
hampering = hmprg
hampers = hmprs
hand = hnd
handed = hndd
handful = hndf
handicap = hndcp
handicaps = hndcps
handle = hndl
handled = hndld
handles = hndls
handling = hndlg
hands = hnds
handsome = hnsm
handwriting = hndritg
handwritten = hndritn
handy = hnde
hang = hng
hanging = hngg
hangs = hngs
haphazard = hphzd
haphazardly = hphzdl
happen = hpn
happened = hpnd
happening = hpng
happens = hpns
happier = hapr
happiest = hapst
happily = hapl
happiness = hapns
happy = hap
harbor = hrbr
hard = hrd
harder = hrdr
hardest = hrdst
hardly = hrdl
hardship = hrdzp
hardships = hrdzps
hardy = hrde
harm = hrm
harmful = hrmf
harmless = hrmls
harmonious = hrmns
harmonize = hrmnz
harmony = hrmn
harness = harns
harpoon = hrpon
harrowing = hrog
harsh = hars
harvest = hrvst
has = hs
hasn't = hsnt
hassle = hsl
haste = hast
hasty = haste
hat = hatt
hatchet = htct
hatchets = htcts
hate = hat
hated = hatd
hates = hats
hating = hatg
hatred = hatrd
hats = hatts
haul = hul
haunted = hantd
haunting = hantg
haunts = hants
have = v
haven = havn
haven't = vnt
having = vg
hay = ha
hazard = hzrd
hazardous = hzrdus
hazards = hzrds
haze = haz
hazy = haze
he = h
he's = hes
head = hed
headache = hedac
headed = hedd
header = hedr
heading = hedg
heads = heds
headway = hdwa
heal = hel
healed = held
healing = helg
heals = hels
health = helt
healthy = helte
heap = hep
heaped = hepd
heaping = hepg
heaps = heps
hear = hear
heard = hard
hearing = hearg
hears = hears
heart = hrt
hearted = hrtd
hearts = hrts
heat = het
heated = hetd
heating = hetg
heats = hets
heaven = hvn
heavens = hvns
heavier = hvr
heaviest = hvst
heavily = hvl
heavy = hv
hedge = hj
hedges = hjs
hedging = hjg
heel = heel
heels = heels
height = hit
heighten = hitn
heightened = hitnd
heights = hits
held = hldd
hello = hlo
helmet = hlmt
helmets = hlmts
help = hlp
helped = hlpd
helper = hlpr
helpful = hlpf
helping = hlpg
helpless = hlpls
helplessness = hlplsns
helps = hlps
her = hr
herd = herd
herds = herds
here = her
heritage = hrtj
hero = hro
heroes = hros
hers = hers
herself = hrsf
hesitancy = hstnc
hesitant = hstnt
hesitate = hstt
hesitated = hsttd
hesitates = hstts
hesitating = hsttg
hesitation = hstz
hibernation = hibrnz
hid = hidd
hidden = hdn
hide = hid
hideous = hdus
hides = hids
hiding = hidg
high = hi
higher = hir
highest = hist
highlight = hilit
highlighted = hilitd
highlights = hilits
highly = hil
highway = hiwa
highways = hiwas
hike = hik
hiked = hikd
hikes = hiks
hiking = hikg
hill = hl
hills = hls
him = hm
himself = hmsf
hinder = hndr
hindered = hindrd
hindering = hindrg
hinders = hndrs
hindrance = hindrnc
hindrances = hindrncs
hindsight = hndsit
hinge = hnj
hinges = hnjs
hinging = hnjg
hint = hint
hints = hints
hire = hire
hired = hird
hires = hirs
hiring = hirg
his = his
historical = hstrcl
histories = hstrs
history = hstr
hit = ht
hitch = htc
hitches = htcs
hits = hts
hitting = htg
hive = hiv
hives = hivs
hobbies = hobs
hobby = hob
hoe = ho
hoes = hos
hold = hld
holder = hldr
holding = hldg
holds = hlds
hole = hol
holes = hols
holiday = hlda
hollow = holo
holly = holl
holy = hole
home = hom
homes = homs
homework = hmwrk
homily = hmil
homing = homg
hone = hon
honest = hns
honestly = hnsl
honesty = hnst
honey = hne
honk = hnk
honked = hnkd
honking = hnkg
honks = hnks
honor = hnr
honored = hnrd
honoring = hnrg
honors = hnrs
hood = hod
hook = hk
hooked = hkd
hop = hp
hope = hop
hoped = hopd
hopeful = hopf
hopeless = hopls
hopes = hops
hoping = hopg
hopped = hoppd
hopping = hoppg
hops = hopps
horizon = hrzn
horizons = hrzns
horizontal = hrzntl
horn = hrn
horns = hrns
horrid = hord
horror = horr
horrors = horrs
horse = hrs
horses = hrss
hospital = hsptl
hospitalization = hsptlzz
hospitals = hsptls
host = host
hostage = hstj
hostile = hstl
hostilities = hstlts
hostility = hstlt
hosts = hosts
hot = hot
hotel = hotl
hotter = hotr
hottest = hotst
hour = hor
hours = hors
house = hus
houses = huss
housing = husg
hover = hovr
hovering = hovrg
hovers = hovrs
how = hw
however = hev
hubris = hubrs
hue = hu
hued = hud
hues = hues
hug = hg
huge = huj
hugged = hgd
hugging = hgg
hugs = hgs
hum = hum
human = humn
humanity = humnt
humanly = humnl
humans = humns
humble = hmb
humbly = hmbl
humid = humid
humidity = humdt
humility = humlt
hummed = humd
humming = humg
humor = humr
humors = humrs
hump = hmp
humped = hmpd
humps = hmps
hunch = hnc
hunches = hncs
hundred = hndrd
hundreds = hndrds
hung = hung
hunger = hngr
hungrier = hngrr
hungriest = hgrst
hungry = hngre
hunt = hnt
hunted = hntd
hunter = hntr
hunters = hntrs
hunting = hntg
hunts = hnts
hurdle = hurdl
hurdles = hurdls
hurried = hurd
hurries = hurs
hurry = hur
hurrying = hurg
hurt = hurt
hurtful = hurtf
hurting = hurtg
hurts = hurts
husband = hsbd
hydraulic = hydrlc
I = i
I'll = il
I'm = im
I've = iv
ice = ice
idea = id
ideal = idel
ideally = idell
ideals = idels
ideas = ids
identical = idntcl
identifiable = idfib
identification = idfcz
identified = idfid
identifies = idfis
identify = idfi
identifying = idfig
identity = idntt
idle = idl
if = if
ignite = ignit
ignition = ignz
ignorance = ignrnc
ignorant = ignrnt
ignore = ignr
ignored = ignrd
ignoring = ignrg
ill = ill
illegal = ilgl
illness = ilns
illuminate = ilmnt
illusion = iluz
illusions = iluzs
illustrate = ilstrt
illustrated = ilstrtd
illustration = ilstrz
image = mj
imagery = mjr
images = mjs
imaginable = mjnb
imaginary = mjnr
imagination = mjnz
imaginative = mjntv
imagine = mjn
imagined = mjnd
imaging = mjg
imagining = mjng
imbalance = mblnc
imbibe = mbib
imbibed = mbibd
imbibes = mbibs
imitate = mtt
imitated = mttd
imitates = mtts
imitation = mtz
immediate = mmdt
immediately = mmdtl
immense = mmns
immensely = mmnsl
immerse = mmers
immersion = mmerz
immigrants = mmgrnts
imminent = mmnnt
immune = mmun
impact = mpct
impacted = mpctd
impacts = mpcts
impair = mpar
impaired = mprd
impart = mprt
impatience = mpasnc
impatient = mpasnt
impatiently = mpasntl
impeccable = mpcb
impede = mped
impediment = mpdm
impediments = mpdms
impending = mpndg
impenetrable = mpntrb
imperative = mprtv
imperceptible = mprcptb
imperfect = mpfct
imperfection = mprfcz
imperfections = mprfczs
impermanent = mpmnt
impersonal = mprsnl
impervious = mprvus
impinging = mpnjg
implanted = mplntd
implement = mplm
implementation = mplntz
implemented = mplmd
implements = mplms
implicate = mplct
implicated = mplctd
implicates = mplcts
implication = mplcz
implications = mplczs
implied = mplid
implies = mplis
implode = mplod
imply = mpli
import = mport
importance = mprtnc
important = mprtt
importantly = mprttl
imports = mports
impose = mpos
imposed = mposd
imposes = mposs
imposing = mposg
impossibility = mpsbt
impossible = mpsb
impoverish = mpvrs
impoverished = mpvrsd
impractical = mprctcl
impress = mprs
impressed = mprsd
impresses = mprss
impression = mprz
impressions = mprzs
impressive = mprsv
imprint = mprnt
improve = mprv
improved = mprvd
improvement = mprvm
improvements = mprvms
improves = mprvs
improving = mprvg
impulse = mpuls
impulses = mpulss
impulsive = mplsv
impulsively = mplsvl
impunity = mpunt
in = n
inability = nabt
inaccurate = nacurt
inaction = nacz
inadequate = nadct
inadequately = nadctl
inane = nan
inappropriate = naprprt
incapable = ncapb
incapacitated = ncpcttd
incentive = ncntv
incentives = ncntvs
inch = nc
inches = ncs
incident = ncdnt
incidental = ncdntl
incidents = ncdnts
inclination = nclnz
inclined = nclind
include = nclud
included = ncldd
includes = ncluds
including = ncludg
income = ncm
incomes = ncms
incoming = ncmg
incompatible = ncptb
incompetent = ncptnt
incomplete = ncplet
incomprehensible = ncprhnsb
inconsequential = ncscnsl
inconsiderate = ncsdrt
inconsistent = ncsstnt
inconstant = ncstnt
inconvenience = ncvnc
inconveniences = ncvncns
inconvenient = ncvnnt
incorporate = ncrprt
incorporated = ncrprtd
incorrect = ncrct
increase = ncrs
increased = ncrsd
increases = ncrss
increasing = ncrsg
increasingly = ncrsgl
incredible = ncrdb
incredibly = ncrdbl
increment = ncrm
incremental = ncrml
increments = ncrms
incursion = ncurz
indeed = nded
indefinite = ndfnt
indefinitely = ndfntl
indelible = ndlb
indelibly = ndlbl
indent = ndnt
independence = ndpndnc
independent = ndpndnt
independently = ndpndntl
index = ndx
indexed = ndxd
indexes = ndxs
indexing = ndxg
indicate = ndct
indicated = ndctd
indicates = ndcts
indicating = ndctg
indication = ndcz
indicator = ndctr
indicators = ndctrs
indirect = ndrct
indispensable = ndspnsb
indistinct = ndstnct
individual = ndvdl
individually = ndvdll
individuals = ndvdls
induce = nduc
indulgence = ndljnc
indulgent = ndljnt
industrial = ndstrl
industries = ndstrs
industry = ndstr
ineffective = nefctv
ineffectiveness = nefctvns
inefficiency = nefcnc
inefficient = nefcnt
inertia = nrza
inescapable = nescpb
inevitable = nevtb
inevitably = nevtbl
inexpensive = nxpnsv
infancy = nfnc
infant = nfnt
infants = nfnts
infect = nfct
infected = nfctd
infects = nfcts
infinite = nfint
infinitely = nfintl
infinity = nfinte
inflame = nflam
inflamed = nflamd
inflames = nflams
inflammation = nflmz
inflammatory = nflmtor
inflation = nflaz
influence = nflnc
influenced = nflncd
influences = nflncs
influencing = nflncg
influential = inflnzl
influx = nflux
inform = nfrm
information = nfrmz
informative = nfrmtv
informed = nfrmd
infrequent = nfrcnt
infrequently = nfrcntl
infuse = nfus
infusion = nfuz
ingenuity = ngnut
ingrained = ngrand
ingredient = ngrdnt
ingredients = ngrdnts
inhabit = nhbt
inhabited = nhbtd
inhabits = nhbts
inhalation = nhlaz
inherent = nhrnt
inherently = nhrntl
inherit = nhrt
inherited = nhrtd
inhibit = nhibt
inhibited = nhibtd
inhibition = nhibz
inhibitions = nhbzs
inhibits = nhibts
initial = nisl
initially = nisll
initiated = instd
initiates = nistts
initiative = nistv
inject = njct
injure = njr
injured = njrd
injures = njrs
injuries = njres
injury = njre
injustice = njstc
injustices = njstcs
ink = ink
inner = nnr
innermost = nrmo
innocence = nocnc
innocent = nocnt
innovate = novt
innovates = novts
innovation = novz
innovative = novtv
input = npt
inputs = npts
inquire = ncir
inquires = ncirs
inquiry = ncire
inquisition = ncsz
inroad = nrod
inroads = nrods
insane = nsan
insect = nsct
insects = nscts
insecure = nscur
insecurity = nscurt
insert = nsrt
inserted = nsrtd
inserts = nsrts
inside = nsid
insidious = nsidus
insight = nsit
insightful = nsitf
insights = nsits
insignificant = nsgnfcnt
insinuate = nsnut
insist = nsst
insisted = nsstd
insistence = nsstnc
insistent = nsstnt
insisting = nsstg
insists = nssts
inspect = nspct
inspected = nspctd
inspecting = nspctg
inspection = nspcz
inspections = nspczs
inspects = nspcts
inspiration = nsprz
inspirational = nsprzl
inspirations = nsprzs
inspire = nspir
inspired = nspird
inspires = nspirs
inspiring = nspirg
install = nstl
installation = nstlz
installed = nstld
installing = nstlg
installment = nstlm
installs = nstls
instance = nstnc
instances = nstncs
instant = nstnt
instantaneous = nstntnus
instantaneously = nstntanusl
instantly = nstntl
instants = nstnts
instead = nsted
instigate = nstgt
instill = nstil
instilled = nstild
instills = nstils
instinct = nstnct
instinctively = nstnctvl
instincts = nstncts
institute = nstut
institutes = nstuts
institution = nstuz
institutions = nstuzs
instruct = nstrct
instructed = nstrctd
instructing = nstrctg
instruction = nstrcz
instructions = nstrczs
instructive = nstrctv
instructs = nstrcts
instrument = nstrm
instrumental = nstrml
instruments = nstrms
insulate = nsult
insulation = nsulz
insult = nslt
insulted = nsltd
insulting = nsltg
insults = nslts
insurance = nsrnc
insure = nsur
insured = nsurd
insures = nsurs
intact = ntct
intake = ntak
intakes = ntaks
integral = ntgrl
integrate = ntgrt
integrated = ntgrtd
integrating = ntgrtg
integration = ntgrz
integrity = ntgrit
intellectual = ntlctl
intellectually = ntlctll
intelligence = ntljnc
intelligent = ntljnt
intelligently = ntljntl
intelligible = ntljb
intend = ntnd
intended = ntndd
intending = ntndg
intends = ntnds
intense = ntns
intensely = ntnsl
intensify = ntnsfi
intensity = ntnst
intensive = ntnsv
intensively = ntnsvl
intent = ntnt
intention = ntnz
intentional = ntnzl
intentionally = ntnzll
intentions = ntnzs
intently = ntntl
interact = ntract
interaction = ntracz
interactions = ntraczs
intercept = ntrcpt
intercepted = ntrcptd
interest = ntrst
interested = ntrstd
interesting = ntrstg
interests = ntrsts
interface = ntrfac
interfere = ntrfr
interfered = ntrfrd
interference = ntrfrnc
interferes = ntrfrs
interfering = ntrfrg
interior = ntrr
intermediate = ntrmdt
interminable = ntrmnb
internal = ntrnl
internalize = ntrnlz
internally = ntrnll
international = ntrnz
interpret = ntrprt
interpretation = ntrprtz
interpretations = ntrprtzs
interpreted = ntrprtd
interrupt = ntrpt
interrupted = ntrptd
interrupting = ntrptg
interruption = ntrpz
interruptions = ntrpzs
interrupts = ntrpts
intersect = itrsct
interval = ntrvl
intervals = ntrvls
intervene = ntrven
intervening = ntrveng
intervention = ntrvnz
intimate = ntmt
intimately = ntmtl
intimidated = ntmdtd
intimidating = ntmdtg
into = nto
intolerance = ntlrnc
intolerant = ntlrnt
intricate = ntrct
intrigue = ntrig
intrigued = ntrigd
intrigues = ntrigs
intriguing = ntrigg
introduce = ntrduc
introduced = ntrducd
introduction = ntrdcz
introspection = ntrspcz
intrude = ntrud
intruder = ntrudr
intruders = ntrudrs
intruding = ntrudg
intrusion = ntruz
intrusions = ntruzs
intrusive = ntrusv
intuition = ntuz
intuitive = ntutv
intuitively = ntutvl
invade = nvad
invaded = nvadd
invalid = nvld
invaluable = nvlub
invent = nvnt
invented = nvntd
inventing = nvntg
invention = nvnz
inventions = nvnzs
inventive = nvntv
inventiveness = nvntvns
inventor = nvntr
inventories = nvntors
inventors = nvntrs
inventory = nvntor
inverse = nvrs
invert = nvrt
invest = nvst
invested = nvstd
investigate = nvstgt
investigated = nvstgtd
investigating = nvstgtg
investigation = nvstgz
investigative = ivstgtv
investing = nvstg
investment = nvstm
investments = nvstms
invigorate = nvgrt
invigorated = nvgrtd
invigorating = nvgrtg
invisible = nvsb
invitation = nvtz
invite = nvit
invited = nvitd
invites = nvits
inviting = nvitg
invoice = nvoc
invoices = nvocs
invoke = nvok
invoked = nvokd
invoking = nvokg
involve = nvlv
involved = nvlvd
involvement = nvlvm
involves = nvlvs
involving = nvlvg
inward = nwd
iron = irn
ironed = irnd
ironic = irnc
ironing = irng
irons = irns
irony = irne
irrational = irznl
irrationally = irznll
irregular = irglr
irrelevant = irlvnt
irresistible = irsstb
irresponsible = irspnsb
irritable = irtb
irritate = irtt
irritated = irttd
irritates = irtts
irritation = irtz
is = s
island = ilnd
islands = ilnds
isn't = snt
isolate = isolt
isolated = isltd
isolation = isolz
issue = isu
issued = isud
issues = isus
it = it
it's = is
Italian = itln
itch = itc
itches = itcs
itching = itcg
item = itm
itemize = itmz
itemized = itmzd
items = itms
its = its
itself = isf
jacket = jkt
jackpot = jkpt
jagged = jgd
jail = jal
jam = jm
jammed = jmd
jangle = jangl
January = jan
Japan = jpn
Japanese = jpns
jar = jar
jarred = jrd
jaws = jws
jealous = jlus
jealously = jlusl
jealousy = jluse
jerk = jrk
jerkiness = jrkns
jerking = jrkg
jerks = jrks
jerky = jrke
jest = jst
jet = jt
jewel = jwl
jewelry = jwlr
jewels = jwls
jiggling = jiglg
jinxed = jnxd
job = jb
jobs = jbs
join = jn
joined = jnd
joining = jng
joins = jns
joint = jnt
joints = jnts
joke = jok
jokes = joks
joking = jokg
jolt = jlt
jolting = jltg
jolts = jlts
jot = jot
jotting = jotg
journal = jrnl
journals = jrnls
journey = jrn
jovial = jovl
joy = jy
joyful = jyf
joyfully = jyfl
joys = jys
judge = jj
judges = jjs
judging = jjg
judgment = jjm
judgments = jjms
judicious = jdsus
juggle = jgl
juggling = jglg
juice = juc
juiced = jucd
juices = jucs
juicy = jce
July = jul
jumble = jmbl
jumbled = jmbld
jump = jmp
jumped = jmpd
jumping = jmpg
jumps = jmps
juncture = jnctr
June = jun
jungle = jngl
junior = jr
junk = jnk
jury = jur
just = j
justice = jc
justifiable = jfib
justification = jfcz
justified = jfid
justifies = jfis
justify = jfi
justifying = jfig
juvenile = jvnl
keel = kel
keen = ken
keep = kp
keeping = kpg
keeps = kps
kept = kpt
kernel = krnl
kernels = krnls
key = ke
keyboard = kbrd
keyboards = kbrds
keyed = ked
keys = kes
keystroke = kstrk
keystrokes = kstrks
keyword = kwrd
kick = kk
kicked = kkd
kicking = kkg
kicks = kks
kid = kd
kids = kds
kill = kl
killed = kld
killer = klr
killing = klg
kills = kls
kilter = kltr
kind = knd
kinder = kndr
kindest = kndst
kindle = kindl
kindly = kndl
kindness = kndns
kinds = knds
king = kig
kingdom = kigdm
kings = kigs
kink = knk
kinks = knks
kiss = kis
kisses = kiss
kissing = kisg
kit = kt
kitchen = kcn
kitchens = kcns
kite = kit
kites = kits
kits = kts
knack = nak
knead = ned
kneads = neds
knee = ne
kneel = nel
kneeling = nelg
knees = nes
knew = ku
knife = nif
knight = nitt
knights = nitts
knives = nivs
knob = nob
knobs = nobs
knock = nok
knocked = nokd
knocking = nokg
knocks = noks
knot = nott
know = k
knowing = kg
knowledge = klj
knowledgeable = kljb
known = kn
knows = ks
label = labl
labeled = labld
labels = labls
labor = labr
laboratory = lab
laboring = labrg
labors = labrs
labs = lbs
lace = lac
laced = lacd
laces = lacs
lacing = lacg
lack = lck
lacking = lakg
lacks = lcks
ladder = ldr
ladders = ldrs
ladies = lads
lady = lad
lag = lgg
lagging = lagg
laid = laid
lake = lak
lakes = laks
lame = lam
lament = lm
lamp = lmp
lamps = lmps
land = lnd
landed = lndd
landing = lndg
lands = lnds
landscape = lndscp
lane = lan
language = lngj
languages = lngjs
languid = lngd
languish = lngs
languishing = lngsg
lantern = lntrn
lap = lap
laps = laps
lapse = lapse
lapsed = lapsd
lapses = lapss
large = lrj
largely = lrjl
larger = lrjr
largest = lrjst
laser = lasr
lash = lash
lashed = lashd
lashing = lashg
last = lst
lasted = lstd
lasting = lstg
lasts = lsts
latch = ltc
latched = ltcd
late = lat
lately = latl
later = latr
lateral = ltrl
laterally = latrll
latest = latst
latitude = lttud
latter = lttr
laugh = laf
laughed = lafd
laughing = lafg
laughs = lafs
laughter = laftr
launch = lwnc
launching = lwncg
laundry = lndr
law = lw
lawn = lwn
laws = lws
lax = lx
lay = la
layer = lar
layers = lars
laying = lag
lays = las
laziness = lzns
lazy = lz
lead = led
leader = ledr
leaders = ledrs
leadership = ledrzp
leading = ledg
leads = leds
leaf = lef
league = leag
leak = lek
leaked = lekd
leaking = lekg
leaks = leks
lean = len
leaned = leand
leaning = leang
leans = lens
leap = lep
leaped = lepd
leapfrog = lepfrg
leaping = lepg
leaps = leps
learn = lrn
learned = lrnd
learners = lrnrs
learning = lrng
learns = lrns
lease = les
leases = less
leash = leash
least = lest
leather = letr
leave = lev
leaves = levs
leaving = levg
lecture = lctur
lectures = lcturs
led = ld
leeway = lewa
left = lf
leg = leg
legacy = lgc
legal = legl
legally = legll
legend = ljnd
legendary = ljndr
legibility = ljbt
legible = ljb
legislation = ljslz
legitimate = ljtmt
legs = legs
leisure = lesr
leisurely = lsurl
lemon = lmn
lend = lend
lenders = lndrs
lending = lending
lends = lends
length = lngt
lengths = lngts
lenient = lennt
lens = lns
lenses = lnss
lent = lent
lesion = lez
lesions = lezs
less = ls
lessen = lsen
lessened = lsend
lesson = lsn
lessons = lsns
let = lt
let's = ltss
letdown = ltdw
lethargy = ltrg
lets = lts
letter = ltr
letters = ltrs
letting = ltg
level = lvl
levels = lvls
lever = lvr
leverage = lvrj
levers = lvrs
liability = libt
liable = lib
liar = lir
liars = lirs
liberate = lbrat
liberating = lbratg
liberties = lbrts
liberty = lbrt
librarian = librrn
librarians = librrns
library = librr
license = lcns
lid = lid
lie = li
lies = lis
life = lif
lifeblood = lifblod
lifeboat = lifbot
lifeboats = lifbots
lifestyle = lifstil
lifestyles = lifstils
lifetime = liftim
lift = lft
lifted = lftd
lifting = lftg
lifts = lfts
light = lit
lighted = litd
lighten = litn
lighter = litr
lightest = litst
lighthearted = lithrtd
lighting = litg
lightly = litl
lightness = litns
lightning = litng
lights = lits
like = lik
liked = likd
likely = likl
likes = liks
likewise = likwz
liking = likg
limber = limbr
limit = lmt
limitation = lmtz
limitations = lmtzs
limited = lmtd
limiting = lmtg
limitless = lmtls
limits = lmts
line = lin
lined = lind
lines = lins
linger = lingr
lingering = lingrg
lining = ling
link = lnk
linked = lnkd
links = lnks
lion = lion
lions = lions
lip = lp
lips = lps
liquid = lcd
liquids = lcds
liquor = lcr
liquors = lcrs
list = list
listed = listd
listen = lisn
listened = lisnd
listening = lisng
listens = lisns
listing = listg
listings = listgs
lists = lists
lit = litt
literal = litrl
literally = litrll
literature = ltrtur
litigate = ltgt
little = ltl
live = liv
lived = livd
lively = livl
lives = livs
living = livg
load = lod
loaded = lodd
loading = lodg
loads = lods
loaf = lof
loan = loan
loans = lons
loathing = lotg
loaves = loavs
local = locl
locally = locll
locate = loct
located = loctd
location = locz
locations = loczs
lock = lok
locked = lokd
locking = lokg
locks = loks
locomotive = lcmtv
locomotives = lcmtvs
loft = loft
lofty = loftthe
log = log
logic = ljc
logical = ljcl
logically = ljcll
logs = logs
lone = lon
loneliness = lonlns
lonely = lonl
long = lng
longer = lngr
longest = lngst
longing = lngg
longings = lnggs
look = lk
looked = lkd
looking = lkg
lookout = lkot
looks = lks
loom = lom
looming = lomg
looms = loms
loop = lop
loops = lops
loose = loos
loosely = loosl
loosen = loosn
loosened = losnd
looseness = losns
loosening = losng
looser = loosr
lose = los
losers = losrs
loses = loss
losing = losg
loss = lss
losses = lsss
lost = lost
lot = lot
lots = lots
loud = lwd
louder = lwdr
loudly = lwdl
lovable = lovb
love = lov
loved = lovd
lovely = lovl
loves = lovs
loving = lovg
low = lo
lower = lor
lowered = lord
lowest = lowst
loyal = lyl
loyalty = lylt
lubrication = lubrcz
lucid = lucd
luck = luk
lucky = luke
lull = lul
lulled = luld
lumber = lmbr
luminous = lumnus
lump = lump
lunch = lunc
lung = lung
lungs = lungs
lure = lur
lured = lurd
lures = lurs
luring = lurg
lurk = lrk
lurking = lrkg
luxuries = lxrs
luxurious = lxrus
luxury = lxr
lying = lig
machine = mcin
machinery = mcinr
machines = mcins
mad = md
made = mad
madness = mdns
magazine = mgzn
magazines = mgzns
magic = mjc
magical = mjcl
magically = mjcll
magnet = mgnt
magnetic = mgntc
magnificence = mgnfcnc
magnificent = mgnfcnt
magnifier = mgnfir
magnify = mgnfi
magnifying = mgnfig
mail = mal
mailed = mald
mailer = malr
mailing = malg
mails = mals
main = man
mainly = manl
mainstay = mansta
maintain = mantn
maintained = mantnd
maintaining = mantng
maintains = mantns
maintenance = mantnnc
majestic = mjstc
majesty = mjst
major = majr
majority = mjrt
make = mak
makes = maks
makeup = makp
making = makg
makings = makgs
male = male
males = males
malfunction = mlfncz
malfunctioning = mlfnczg
malignant = mlgnnt
malleable = malb
mammal = mml
mammals = mmls
man = mn
manage = mnj
manageable = mnjb
managed = mnjd
management = mnjm
manager = mnjr
managers = mnjrs
manages = mnjs
managing = mnjg
mandatory = mndtr
maneuver = mnuvr
maneuvers = mnuvrs
manifest = mnfst
manifestation = mnfstz
manipulate = mnpult
manipulated = mnpultd
manipulating = mnpultg
manipulation = mnpulz
manner = mnr
manners = mnrs
manual = mnul
manually = mnull
manufacture = mnfctr
manufactured = mnfctrd
manufacturers = mnfctrrs
manufacturing = mnfctrg
manuscript = mnscrpt
many = mne
map = mp
mapped = mpd
maps = mps
mar = marr
marathon = mrton
March = mar
march = mrc
marched = mrcd
marches = mrcs
marching = mrcg
margin = mrjn
marginal = mrjnl
marginally = mrjnll
margins = mrjns
marine = mrin
mark = mrk
marked = mrkd
marker = mrkr
markers = mrkrs
market = mrkt
marketable = mrktb
marketing = mrktg
markets = mkts
marking = mrkg
marks = mrks
marriage = marj
married = mrd
marry = mare
mars = mrs
martial = mrsl
marvel = mrvl
marvelous = mrvlus
marvelously = mrvlusl
marvels = mrvls
mask = msk
masks = msks
mass = mas
massage = masj
masses = mass
massive = msv
master = mstr
mastered = mstrd
masterful = mstrf
mastering = mstrg
masterpiece = mstrpc
masters = mstrs
masterworks = mstrwrks
mastery = mstre
match = mtc
matched = mtcd
matches = mtcs
matching = mtcg
matchless = mtcls
mate = mat
material = mtrl
materialistic = mtrlstc
materialize = mtrlz
materials = mtrls
mates = mats
mathematical = mtmtcl
mathematics = mtmtcs
mats = mts
matter = mtr
mattered = mtrd
matters = mtrs
mature = mtur
maturity = mturt
maximal = mxml
maximize = mxmz
maximum = mxm
may = ma
May = may
maybe = mb
mayor = myr
maze = maz
mazes = mazs
me = me
meadow = mdo
meal = mel
meals = mels
mean = men
meaning = meng
meaningful = mengf
meaningless = mengls
meanings = mengs
means = mens
meant = ment
meantime = mentm
meanwhile = menwil
measure = msur
measured = msurd
measurement = msurm
measurements = msurms
measures = msurs
measuring = msurg
meat = meat
mechanical = mcncl
mechanically = mcncll
mechanics = mcncs
mechanism = mcnsm
mechanisms = mcnsms
mechanization = mcnzz
medal = mdal
medals = mdals
meddle = medl
medical = mdcl
medication = mdcz
medicine = mdcn
medicines = mdcns
mediocre = mdocr
meditate = mdtt
meditation = mdtz
medium = mdm
meet = met
meeting = metg
meetings = metgs
meets = mets
melancholy = mlcol
mellow = mlo
melody = mlod
melt = mlt
meltdown = mltdw
melted = mltd
melting = mltg
melts = mlts
member = mbr
members = mbrs
membership = mmbrzp
memo = mmo
memorable = mmrb
memorial = mmrl
memories = mmrs
memorize = mmrz
memorized = mmrzd
memory = mmr
men = mnn
mend = mend
mended = mendd
mending = mendg
mends = mends
mental = mntl
mentally = mntll
mention = mnz
mentioned = mnzd
mentioning = mnzg
mentions = mnzs
menu = mnu
menus = mnus
merchandise = mrcndis
merchant = mrcnt
mercury = mrcur
mercy = merc
mere = mer
merely = merl
merge = mrj
merged = mrjd
merit = mrt
merrier = mrrr
merry = mrr
mess = mes
message = msj
messages = msjs
messed = mesd
messes = mess
messing = mesg
messy = mese
met = mt
metabolic = mtblc
metal = mtl
metals = mtls
metaphor = mtfr
metaphors = mtfrs
meter = metr
method = mtd
methodical = mtdcl
methodically = mtdcll
methods = mtds
meticulous = mtclus
Mexico = mxco
microphone = mcfon
microphones = mcfons
microscope = mcrscp
microscopes = mcrscps
microscopic = mcrscpc
microsecond = mcscnd
microseconds = mcscnds
middle = mdl
midnight = mdnit
midst = mdst
might = mit
mighty = mite
migrate = migrt
mild = mld
mile = mil
mileage = milj
miles = mils
milestone = milston
milestones = milstons
military = mltr
milk = mlk
milked = mlkd
mill = ml
millimeter = mm
millimeters = mms
million = miln
millions = milns
mills = mls
mimic = mmc
mind = mnd
mind's = mndss
minded = mndd
mindedly = mnddl
mindful = mndf
minding = mndg
minds = mnds
mine = min
mineral = mnrl
minerals = mnrls
mines = mins
minimal = mnml
minimize = mnmz
minimum = mnm
minister = mnstr
minor = minr
minute = mnut
minutes = mnuts
miracle = mrcl
miracles = mrcls
miraculous = mrculus
mire = mir
mired = mird
mirror = mror
mirrors = mrrs
mischief = mscef
misconceptions = mscpzs
misdirected = msdrctd
miserable = msrb
misery = msre
misfortune = msftun
misinterpret = msntrprt
misinterpretation = msntrprtz
misjudged = msjjd
misleading = msledg
misled = msld
misperception = mspcpz
misplaced = msplcd
miss = ms
missed = msd
misses = mss
missile = misl
missiles = misls
missing = msg
mission = mz
misspell = mspel
misspelled = mspeld
mist = mst
mistake = mstk
mistaken = mstkn
mistakes = mstks
mistaking = mstkg
mistook = mtk
misunderstanding = msustndg
mix = mx
mixed = mxd
mixes = mxs
mixing = mxg
mixture = mxtr
mob = mob
mobility = moblt
mobilize = moblz
mobilized = moblzd
mobs = mobs
mode = mode
model = modl
models = modls
moderate = mdrt
moderation = mdrz
modern = mdrn
modes = modes
modification = mdfcz
modifications = mdfczs
modified = mdfid
modifiers = mdfirs
modify = mdfi
modulate = mdlt
module = mdul
moist = myst
moisture = mystr
mold = mold
molds = molds
molecules = mols
moment = mom
moment's = momss
moments = moms
momentum = mmtm
Monday = mon
money = mone
monitor = mntr
monitored = mntrd
monitoring = mntrg
monitors = mntrs
monopoly = mnpl
monster = monstr
month = mont
monthly = montl
months = monts
monument = mnum
mood = mod
moods = mods
moon = moon
moral = mrl
morbid = mrbd
more = mr
moreover = mrov
morning = mrng
mornings = mrngs
morose = mros
mortal = mrtl
mortality = mrtlt
mortals = mrtls
mortgage = mrgj
most = mo
mostly = mol
mother = motr
mothers = motrs
motion = moz
motionless = mozls
motions = mozs
motivate = motvt
motivated = motvtd
motivates = motvts
motivating = motvtg
motivation = motvz
motivational = motvzl
motive = motv
motives = motvs
motor = motor
mount = mnt
mountain = mntn
mountains = mntns
mounted = mntd
mounting = mntg
mounts = mnts
mourn = morn
mournful = mornf
mouth = mot
move = mv
moveable = mvb
moved = mvd
movement = mvm
movements = mvms
moves = mvs
movie = mve
movies = mves
moving = mvg
much = mc
muck = muk
mud = mud
muddle = mudl
muddled = mudld
muddles = mudls
multiple = mltpl
multiplied = mltplid
multiply = mltpli
multiplying = mltplig
murder = mrdr
murdered = mrdrd
murdering = mrdrg
murders = mrdrs
murmur = murmr
murmuring = murmrg
murmurs = murmrs
muscle = musl
muscled = musld
muscles = musls
museum = musm
museums = musms
music = musc
musical = muscl
musing = musg
must = mu
muster = mustr
mustered = mustrd
mute = mut
muted = mutd
mutes = muts
mutual = mutl
my = mi
myself = msf
mysteries = mistrs
mysterious = mistrus
mystery = mistr
mystical = mstcl
myth = myt
mythical = mytcl
myths = myts
nag = nag
nagging = ngg
nail = nal
nailed = nald
nails = nals
naive = naiv
name = nam
named = namd
names = nams
naming = namg
nap = nap
napkin = npkn
narcissistic = nrcsstc
narcotics = nrctcs
narrow = nro
narrowing = nrog
narrows = nros
nation = naz
national = nzl
nations = nazs
native = natv
natives = natvs
natural = ntrl
naturally = ntrll
nature = natr
naughty = nute
navigate = nvgt
navigation = nvgaz
navy = nav
near = nr
nearby = nrbi
nearer = nrr
nearest = nrst
nearly = nrl
neat = net
neatly = netl
necessarily = ncsrl
necessary = ncsr
necessity = ncst
neck = nk
need = nd
needed = ndd
needing = ndg
needle = nedl
needles = nedls
needless = ndls
needlessly = ndlsl
needs = nds
needy = nde
negative = ngtv
negatively = ngtvl
negatives = ngtvs
negativity = ngtvt
neglect = nglct
neglected = nglctd
neglecting = nglctg
negligence = ngljnc
negligent = ngljnt
negotiate = ngozt
negotiated = ngostd
negotiating = ngoztg
negotiation = ngozz
negotiations = ngoszs
neighbor = nabr
neighborhood = nbrhd
neighboring = nabrg
neighbors = nbrs
neither = netr
nephew = nfu
nephews = nefus
nerve = nrv
nerves = nrvs
nervous = nrvus
nervously = nrvusl
nest = nst
nested = nstd
nests = nsts
net = nett
network = ntwrk
networks = ntwrks
neurological = nrljcl
never = nv
nevertheless = nvels
new = nu
newer = nur
newest = nust
news = nus
newspaper = nusppr
newspapers = nuspprs
next = nx
nice = nic
nicely = nicl
niche = nich
niece = nec
nieces = necs
night = nit
nightfall = nitfl
nightly = nitl
nightmare = nitmr
nightmares = nitmrs
nights = nits
nimble = nmbl
nine = nin
ninety = ninte
no = no
noble = nobl
nobody = nbd
nod = nod
nodded = nodd
node = node
nodes = nodes
noise = nys
noises = nyss
noisy = nyse
nominal = nmnl
none = nn
nonetheless = nnels
nonsense = nnsns
nonstop = nnstop
noon = non
nor = nor
normal = nrml
normally = nrmll
north = nrt
northern = nrtrn
nose = nos
not = nt
notable = notb
notably = notbl
notation = notz
notch = ntc
note = not
noted = notd
notes = nots
nothing = ng
notice = notc
noticeable = notcb
noticed = notcd
notices = notcs
noticing = notcg
notify = notfi
noting = notg
notion = noz
notions = nozs
nourish = nrs
nourishes = nrss
nourishment = nrsm
novel = nvl
novelty = nvlt
November = nov
novice = novc
now = nw
nowhere = nowr
nuance = nunc
nuances = nuncs
nuclear = nclr
nudge = ndj
nudged = ndjd
nudges = ndjs
nudging = ndjg
nuisance = nusnc
numb = num
number = nmbr
numbered = nmbrd
numbering = nmbrg
numbers = nmbrs
numeral = numrl
numerals = numrls
numerous = numrus
nurse = nurs
nursing = nrsg
nurture = nrtr
nurtured = nrtrd
nurtures = nrtrs
nurturing = nturg
nutrition = nutrz
nuts = nuts
o'clock = oclk
oak = oak
oaks = oaks
obedience = obdnc
obedient = obdnt
obediently = obdntl
obese = obes
obey = oba
obeyed = obad
obeying = obag
obeys = obas
object = objct
objected = objctd
objection = objcz
objectionable = objczb
objections = objczs
objective = objctv
objectively = objctvl
objectives = objctvs
objects = objcts
obligated = oblgtd
obligation = oblgz
obligations = oblgzs
obliterate = obltrt
obliterated = obltrtd
oblivion = oblvn
oblivious = oblvus
obnoxious = obnxus
obscure = obscr
obscured = obscurd
obscurity = obscurt
observant = obsrvnt
observation = obsrvz
observations = obsrvzs
observe = obsrv
observed = obsrvd
observer = obsrvr
observing = obsrvg
obsess = obss
obsessed = obssd
obsession = obsz
obsessions = obszs
obsessive = obssv
obsolete = obslet
obstacle = obstcl
obstacles = obstcls
obstinate = obstnt
obstruct = obstrct
obstructing = obstrctg
obstruction = obstrcz
obstructions = obstrczs
obstructs = obstrcts
obtain = obtan
obtainable = obtanb
obtained = obtand
obtaining = obtang
obtains = obtans
obvious = obvus
obviously = obvusl
occasion = ocz
occasional = ocazl
occasionally = ocazll
occasions = oczs
occupation = ocpaz
occupations = ocupazs
occupied = ocpid
occupy = ocpi
occur = ocr
occurred = ocrd
occurrence = ocrnc
occurring = ocrg
occurs = ocrs
ocean = ocn
oceans = ocns
October = oct
odd = od
odds = ods
odor = odr
of = o
off = of
offend = ofnd
offended = ofndd
offending = ofndg
offends = ofnds
offensive = ofnsv
offer = ofr
offered = ofrd
offering = ofrg
offerings = ofrgs
offers = ofrs
office = ofc
officer = ofcr
officers = ofcrs
offices = ofcs
official = ofcl
officials = ofcls
offset = ofst
often = ofn
oil = yl
oiled = yld
oiling = ylg
oils = yls
OK = ok
old = ol
older = olr
oldest = olst
omens = omns
ominous = omnus
omission = omz
omit = omt
on = on
once = onc
one = one
one's = oness
ones = ones
ongoing = ongg
only = onl
onto = ont
onward = onwd
ooze = oz
oozes = ozs
opaque = opc
open = opn
opened = opnd
opener = opnr
opening = opng
openings = opngs
openly = opnl
opens = opns
operate = oprt
operated = oprtd
operates = oprts
operating = oprtg
operation = oprz
operational = oprzl
operations = oprzs
operator = oprtr
operators = oprtrs
opinion = opnn
opinions = opnns
opportunities = oprtnts
opportunity = oprtnt
oppose = opos
opposed = opsd
opposes = oposs
opposing = opsg
opposite = opst
oppressive = oprsv
optic = optc
optical = optcl
optimal = optml
optimism = optmsm
optimist = optmst
optimistic = optmstc
optimistically = optmstcl
optimize = optmz
optimum = optmm
option = opz
optional = opzl
optionally = opzll
options = opzs
opulent = opulnt
or = or
oral = orl
orally = orll
orange = ornj
oranges = ornjs
orbit = orbt
orbits = orbts
orchestra = orcstra
orchestras = orcstras
ordeal = ordel
ordeals = ordels
order = ordr
ordered = ordrd
ordering = ordrg
orderly = ordrl
orders = ordrs
ordinarily = ordnrl
ordinary = ordnr
ore = ore
ores = ores
organ = orgn
organic = orgnc
organically = orgncl
organism = orgnsm
organization = orgnzz
organizations = orgnzzs
organize = orgnz
organized = orgnzd
organizes = orgnzs
organizing = orgnzg
organs = orgns
orient = orint
orientation = orntz
oriented = orintd
origin = orjn
original = orjnl
originality = orjnlt
originally = orjnll
originate = orjnt
originates = orjnts
origination = orjnz
origins = orjns
ornament = ornm
ornaments = ornms
ornate = ornt
other = otr
other's = otrss
others = otrs
otherwise = otrwz
ought = out
ounce = oc
our = our
ours = ours
ourselves = orsvs
out = ot
outburst = otbrst
outbursts = otbrsts
outcome = otcm
outcomes = otcms
outdoors = otdors
outer = outr
outgoing = otgg
outlast = otlst
outlet = otlt
outlets = otlts
outline = otlin
outlined = otlind
outlines = otlins
outlook = otlk
outmoded = otmodd
outpouring = otporg
output = otp
outputs = otps
outrageous = otrjus
outreach = otrec
outset = otst
outside = otsid
outsiders = otsidrs
outsmart = otsmrt
outspoken = otspkn
outstanding = otstndg
outward = otwrd
outweigh = otweg
outwit = otwt
outwits = otwts
outwitted = otwtd
outwitting = otwtg
oval = ovl
ovals = ovls
oven = ovn
ovens = ovns
over = ov
overall = oal
overcame = ocam
overcast = ocst
overcome = ocm
overcomes = ocms
overcoming = ocmg
overdo = odo
overdoing = odg
overdone = odn
overdue = odu
overestimate = oestmt
overestimating = oestmtg
overexert = oxrt
overexerting = oxrtg
overextend = oxtnd
overextending = oxtnding
overflow = oflo
overhaul = ohul
overhead = ohed
overjoyed = ojyd
overlap = olp
overload = olod
overloaded = olodd
overlook = olk
overlooked = olkd
overlooking = olkg
overnight = onit
overpower = opwr
overpowering = opwrg
overreact = orct
override = orid
overrides = orids
overriding = oridg
oversight = osit
overturn = otrn
overturned = otrnd
overturning = otrng
overview = ovw
overwhelm = owlm
overwhelmed = owlmd
overwhelming = owlmg
overwhelms = owlms
overwork = owrk
overworking = owrkg
owe = ow
owed = owd
owing = owg
owl = owl
owls = owls
own = own
owned = ond
owner = ownr
owners = ownrs
oxide = oxid
oxygen = ox
pace = pac
paced = pacd
paces = pacs
pacific = pcfc
pacification = pcfcz
pacing = pacg
pack = pk
package = pkj
packaged = pkjd
packages = pkjs
packaging = pkjg
packed = pkd
packets = pakts
packing = pkg
pact = pct
pacts = pcts
pad = pd
pads = pds
page = pj
pages = pjs
paid = pad
pain = pan
painful = panf
painfully = panfl
painless = panls
pains = pans
paint = pant
painted = pantd
painting = pantg
pair = par
pairs = pars
palace = palc
pale = pal
pales = pals
pall = pall
palm = plm
palms = plms
pamper = pmpr
pampered = pmprd
pampering = pmprg
pan = pn
panel = pnl
panels = pnls
pangs = pngs
panic = pnc
panicked = pncd
panicking = pncg
panics = pncs
pans = pns
paper = papr
papers = paprs
parade = prad
paradigm = prdim
paradigms = prdims
paradise = prdis
paradox = pdox
paradoxes = pdoxs
paradoxical = pdoxcl
paragraph = pgrf
paragraphs = pgrfs
parallel = prll
parallels = prlls
paralyzed = prlzd
paralyzing = prlzg
parameter = prmtr
parameters = prmtrs
paraphernalia = prafnla
parcel = prcl
parceled = prcld
parcels = prcls
parent = parnt
parents = parnts
parish = paris
parishes = pariss
parity = parit
park = prk
parks = prks
parodies = pards
parody = pard
part = prt
partial = prsl
partially = parsll
participant = prtcpnt
participants = prtcpnts
participate = prtcpt
participated = prtcptd
participating = prtcptg
participation = prtcpz
particles = prtcls
particular = prtclr
particularly = prtclrl
parties = prtes
parting = prtg
partition = prtz
partly = prtl
partner = prtnr
partners = prtnrs
partnership = prtnrzp
parts = prts
party = prte
pass = ps
passage = psj
passages = psjs
passed = psd
passenger = psnjr
passengers = psnjrs
passes = pss
passing = psg
passion = pz
passionate = pznt
passionately = pzntl
passions = pzs
passive = psv
passively = psvl
passivity = psvt
past = pst
paste = past
pasted = pastd
pastes = pasts
pasting = pastg
pasture = pastr
pat = patt
patch = ptc
patched = ptcd
patches = ptcs
patching = ptcg
patchy = ptce
path = pat
paths = pats
pathway = patwa
pathways = patwas
patience = pasnc
patient = pasnt
patiently = pasntl
patients = pasnts
patter = ptr
pattern = ptrn
patterns = ptrns
pause = pws
pauses = pwss
pausing = pwsg
pave = pav
paved = pavd
paw = paw
paws = paws
pay = pa
payable = pab
paycheck = pack
paying = pag
payment = pam
payments = pams
payoff = paof
payroll = parl
pays = pas
peace = pec
peaceful = pecf
peacefully = pecfl
peak = pek
peaked = pekd
peaks = peks
peculiar = pculr
pedal = pdl
peel = pel
peeled = peld
peeling = pelg
peels = pels
peer = per
peering = perg
peers = pers
pen = pen
penalties = pnlts
penalty = pnlt
pencil = pncl
pencils = pncls
penetrate = pntrt
penetrated = pntrtd
penetrates = pntrts
penetrating = pntrtg
penetration = pntrz
pens = pens
people = pepl
people's = pepls
pepper = pepr
peppers = peprs
per = pr
perceive = pcev
perceived = pcevd
perceives = pcevs
perceiving = pcevg
percent = pcnt
percentage = pcntj
perception = pcpz
perceptive = pcptv
perfect = pfct
perfected = pfctd
perfecting = pfctg
perfection = pfcz
perfectionist = pfczst
perfectly = pfctl
perforate = pfort
perform = pfrm
performance = pfrmnc
performances = pfrmncs
performed = pfrmd
performer = pfrmr
performing = pfrmg
performs = pfrms
perfume = pfum
perfumes = pfums
perhaps = phps
period = prod
periodically = prodcll
periods = prods
peripheral = prfrl
peripherally = prfrll
perishable = prisb
permanent = pmnt
permanently = pmntl
permeate = prmet
permeated = prmetd
permeates = prmets
permission = pmz
permissive = pmsv
permit = pmt
permits = pmts
permitted = pmtd
permitting = pmtg
perpetual = pptul
perplex = pplx
perplexed = pplxd
perplexing = pplxg
perseverance = psvrnc
persevere = psvr
persist = psst
persisted = psstd
persistence = psstnc
persistent = psstnt
persisting = psstg
persists = pssts
person = prsn
personal = prsnl
personality = prsnlt
personally = prsnll
personnel = prsnel
persons = prsns
perspective = pspctv
perspectives = pspctvs
persuade = psuad
persuaded = psuadd
persuading = psuadg
pertinent = ptnnt
perturb = pturb
perturbing = pturbg
pervade = pvad
pervades = pvads
pervasive = pvasv
perverse = pvrs
pessimism = psmsm
pessimist = psmst
pessimistic = psmstc
pet = pet
pets = pets
petting = petg
petty = pete
petulant = ptulnt
phase = fas
phases = fass
phasing = fasg
phenomena = fnmna
phenomenon = fnmnn
philosophical = flsfcl
philosophy = flsf
phone = fon
phonograph = fongrf
photoelectric = fotlctrc
photograph = fotgrf
photographic = fotgrfc
phrase = frz
phrases = frzs
phrasing = frzg
physical = fscl
physically = fscll
physician = fscn
physics = fscs
piano = pino
pianos = pinos
pick = pik
picked = pikd
picking = pikg
picks = piks
picnic = pcnc
picture = pctr
pictured = pctrd
pictures = pctrs
pie = pi
piece = pc
pieces = pcs
pierce = perc
pierced = percd
piercing = percg
pies = pis
pig = pig
pigs = pigs
pile = pil
piled = pild
piles = pils
piling = pilg
pill = pl
pillar = pilr
pills = pls
pilot = pilt
pilots = pilts
pin = pin
pinch = pinc
pinched = pincd
pinching = pincg
pine = pine
pines = pines
pink = pnk
pinnacle = pincl
pinnacles = pincls
pins = pins
pioneer = piner
pioneers = piners
pipe = pip
pipes = pips
pirate = pirt
pirated = pirtd
pirates = pirts
pit = pit
pitch = pitc
pitched = pitcd
pitcher = ptcr
pitching = pitcg
pities = ptes
pitiful = ptf
pits = pits
pity = pte
pivot = pvot
pivotal = pvtl
pivoted = pvotd
pivots = pvots
pizzazz = pzz
place = plc
placed = plcd
placement = plcm
places = plcs
placid = plcid
placing = plcg
plagued = plagd
plaguing = plagg
plain = plan
plainly = planl
plains = plans
plan = pln
plane = plane
planes = planes
planet = plnet
planets = plnets
planned = plnd
planning = plng
plans = plns
plant = plnt
planted = plntd
planting = plntg
plants = plnts
plaster = plstr
plastered = plstrd
plastic = plstc
plastics = plstcs
plate = plat
plateau = pltu
plates = plats
platform = pltfrm
platter = pltr
platters = pltrs
play = pla
played = plad
player = plar
players = plars
playful = plaf
playfulness = plaflns
playing = plag
plays = plas
plea = ple
plead = pled
pleading = pledg
pleasant = plsnt
pleasantly = plsntl
please = ples
pleased = plesd
pleases = pless
pleasing = plesg
pleasurable = plsrb
pleasure = plsr
pleasures = plsrs
pledge = plj
pledged = pljd
pledges = pljs
pledging = pljg
plentiful = plentf
plenty = plent
pliers = plirs
plight = plit
plodding = plodg
plot = plot
plots = plots
plotted = plotd
plotting = plotg
plow = plw
plowed = plwd
plowing = plwg
plows = plws
ploy = ply
pluck = plk
plucked = plkd
plucking = plkg
plug = plg
plugged = plgd
plugging = plgg
plugs = plgs
plum = plum
plums = plums
plunge = plnj
plunged = plnjd
plunger = plnjr
plunging = plnjg
plural = plrl
plurals = plrls
plus = plus
pocket = pkt
pocketing = pktg
pockets = pkts
poem = pom
poems = poms
poet = poet
poetry = poetr
poignant = pygnnt
point = pnt
pointed = pntd
pointing = pntg
pointless = pntls
points = pnts
poise = pys
poised = pysd
poison = pysn
poisoned = pysnd
poisonous = pysnus
poisons = pysns
poke = pok
poker = pokr
pokes = poks
poking = pokg
pole = pol
poles = pols
police = polc
policeman = polcm
policies = plics
policing = polcg
policy = plic
polish = polis
polished = polisd
polishes = poliss
polishing = polisg
polite = polit
politely = politl
political = pltcl
politics = poltcs
pollute = plut
pond = pnd
ponder = pndr
ponderous = pndrus
ponds = pnds
pool = pool
pools = pools
poor = por
poorer = porr
poorest = porst
pop = pp
popped = ppd
popping = ppg
pops = pps
popular = pplr
popularity = pplrt
populate = pplt
population = pplz
pork = pork
port = port
portability = prtbt
portable = prtb
portion = porz
portions = porzs
portray = prtra
portrayed = prtrad
portrays = prtras
ports = ports
pose = pos
posed = posd
poses = poss
posing = posg
position = posz
positioned = poszd
positioning = poszg
positions = poszs
positive = pstv
positively = pstvl
possess = posss
possession = possz
possessions = posszs
possibilities = psbts
possibility = psbt
possible = psb
possibly = psbl
post = post
postage = pstj
posted = postd
posterity = postrt
posthumously = pstumsl
posting = postg
postpone = ppon
postponed = pstpnd
postponing = pstpong
posts = posts
posture = pstur
pot = pot
potato = ptato
potency = ptnc
potent = potnt
potential = potnsl
potentially = potnsll
pots = pots
potted = potd
pottery = potr
poultry = pultr
pounce = ponc
pounced = poncd
pounces = poncs
pouncing = poncg
pound = pond
pounded = pondd
pounding = pondg
pounds = ponds
pour = pour
poured = purd
pouring = purg
pours = purs
poverty = pvrt
powder = pwdr
power = pwr
powered = pwrd
powerful = pwrf
powerfully = pwrfl
powerless = pwrls
powers = pwrs
practical = pctcl
practically = pctcll
practice = pctc
practiced = pctcd
practices = pctcs
practicing = pctcg
prairie = prr
prairies = prrs
praise = praz
praised = prasd
praises = prazs
praiseworthy = prazwrt
praising = prasg
pray = pra
prayer = prar
prayers = prars
prays = pras
preach = prec
preached = precd
preaches = precs
preaching = precg
precarious = pcrus
precaution = pcuz
precautions = pcuzs
precede = prced
preceded = prcedd
precedence = pcdnc
precedent = pcdnt
precedes = prceds
preceding = prcedg
precious = psus
precipitated = pcpttd
precise = pcis
precisely = pcisl
precision = pcz
preconceived = pccevd
preconceptions = pccpzs
predicament = pdcm
predicaments = pdcms
predict = pdict
predictable = pdictb
predicted = pdictd
predicting = pdictg
prediction = pdicz
predictions = pdiczs
predominant = pdmnnt
predominate = pdmnt
preface = pfac
prefer = pfr
preferable = pfrb
preferably = pfrbl
preference = pfrnc
preferences = pfrncs
preferred = pfrd
prefers = pfrs
pregnancy = pgrnnc
pregnant = pgnnt
prejudice = pjdc
prejudiced = pjdcd
prejudices = pjdcs
preliminaries = plmnrs
preliminary = plmnr
premature = pmtur
prematurely = pmturl
premium = prmm
premiums = pmms
premonition = pmnz
premonitions = pmnzs
preoccupation = pocpaz
preoccupied = pocpid
preoccupy = pocpi
preparation = pparz
preparations = pparzs
prepare = ppar
prepared = ppard
prepares = ppars
preparing = pparg
prescribe = pscrib
prescribed = pscribd
prescription = pscpz
prescriptions = pscpzs
presence = psnc
present = psnt
presentable = psntb
presentation = psntz
presentations = psntzs
presented = psntd
presenting = psntg
presently = psntl
presents = psnts
preserve = psrv
preserved = psrvd
preserves = psrvs
preside = psid
presided = psidd
president = psdnt
presidents = psdnts
presides = psids
press = prs
pressed = prsd
presses = prss
pressing = prsg
pressure = prsr
pressured = prsrd
pressures = prsrs
prestige = pstij
presumably = psumbl
presume = psum
presumed = psumd
presumption = psmz
presumptuous = psmtus
pretend = ptnd
pretended = ptndd
pretending = ptndg
pretense = ptns
pretenses = ptnss
pretensions = ptnzs
pretentious = ptnsus
pretty = pret
prevail = pval
prevailing = pvalg
prevails = pvals
prevalent = pvlnt
prevent = pvnt
prevented = pvntd
preventing = pvntg
prevention = pvnz
prevents = pvnts
preview = pvw
previews = pvws
previous = pvus
previously = pvusl
prey = prey
preys = preys
price = pric
priceless = pricls
prices = pricss
pride = prid
priest = prst
primarily = primrl
primary = primr
prime = prim
primitive = prmtv
prince = prnc
princes = prncs
princess = prnces
princesses = prncess
principal = ppal
principals = ppals
principle = ppl
principled = ppld
principles = ppls
print = prnt
printed = prntd
printer = prntr
printers = prntrs
printing = prntg
prints = prnts
prior = prir
priorities = prirts
priority = prirt
prism = prsm
prison = prz
prisoner = przr
prisons = przs
pristine = pstn
privacy = privc
private = pvt
privately = privtl
privilege = prvlj
privileged = pvljd
privileges = prvljs
prize = priz
prized = prizd
prizes = prizs
probability = pbbt
probable = pbb
probably = pbbl
probe = prob
probed = probd
probes = probs
probing = probg
problem = pblm
problematic = pblmtc
problems = pblms
procedure = pcedr
procedures = pcedrs
proceed = pced
proceeding = pcedg
proceeds = pceds
process = prcs
processed = prcsd
processes = prcss
processing = prcsg
processor = prcssr
processors = prcssrs
procrastinate = pcrstnt
procure = pcur
prod = prd
prodigal = pdgl
produce = pduc
produced = pducd
produces = pducs
producing = pducg
product = pdct
production = pdcz
productive = pdctv
productively = pdctvl
productivity = pdctvt
products = pdcts
profess = pfs
professes = pfss
profession = pfz
professional = pfzl
professionals = pfzls
professions = pfzs
professor = prfsr
professors = prfsrs
proficiency = pfcnc
proficient = pfcnt
proficiently = pfcntl
profile = pfil
profiles = pfils
profit = pft
profitability = pftbt
profitable = pftb
profitably = pftbl
profits = pfts
profound = pfond
profoundly = pfondl
profuse = pfus
profusion = pfuz
prognosis = pgnss
program = pgrm
programs = pgrms
progress = pgrs
progressed = pgrsd
progresses = pgrss
progressing = pgrsg
progression = pgrsz
progressive = pgrsv
prohibited = phbtd
prohibitive = phbtv
project = pjct
projected = pjctd
projecting = pjctg
projection = pjcz
projections = pjczs
projects = pjcts
proliferation = plifrz
prolific = plifc
prolong = plong
prolonged = plongd
prolonging = plongg
prominence = pmnnc
prominent = pmnnt
prominently = pmnntl
promise = prms
promised = prmsd
promises = prmss
promising = prmsg
promote = pmot
promoted = pmotd
promoting = pmotg
promotion = pmoz
promotions = pmozs
prompt = prmt
prompted = pmptd
prompting = pmptg
promptly = pmptl
prompts = pmpts
prone = pron
pronounce = pnnc
pronounced = pnncd
pronunciation = pnncz
proof = prof
propaganda = ppgnda
propel = ppel
propelled = ppeld
proper = ppr
properly = pprl
properties = pprts
property = pprt
proportion = pporz
proportions = pprzs
proposal = pposl
propose = ppos
proposed = pposd
proposes = pposs
proposing = pprosg
proposition = pposz
prose = pros
prosecution = pscuz
prospect = pspct
prospective = prspctv
prospects = pspcts
prosper = pspr
prosperity = prsprt
prosperous = psprus
protect = ptct
protected = ptctd
protecting = ptctg
protection = ptcz
protective = ptctv
protects = ptcts
protest = ptst
protested = ptstd
protesting = ptstg
protocol = ptocol
proud = prwd
proudly = prwdl
prove = prv
proved = prvd
proven = prvn
proves = prvs
provide = pvid
provided = pvidd
provides = pvids
providing = pvidg
proving = prvg
provisions = pvzs
provocation = pvocz
provocative = pvoctv
provoke = pvok
prudence = prudnc
prudent = prudnt
prune = prun
pruning = prung
pry = pri
psychiatry = scitr
psychological = scljcl
psychologically = scljcll
psychologist = sclgst
psychology = sclg
public = pblc
publication = pblcz
publications = pblczs
publish = pbls
published = pblsd
publisher = pblsr
publishing = pblsg
puddle = pudl
puddles = pudls
pull = pul
pulled = puld
pulley = pule
pulleys = pules
pulling = pulg
pulls = puls
pulse = pulse
pump = pmp
pumped = pmpd
pumping = pmpg
pun = pun
punch = punc
punched = puncd
punches = puncs
punching = puncg
punish = puns
punished = pnsd
punishes = pnss
punishing = pnsg
punishment = pnsm
punitive = pntv
pupils = pupls
purchase = purcs
purchased = purcsd
purchases = purcss
purchasing = purcsg
pure = pur
purely = purl
purge = prj
purged = prjd
purging = prjg
purified = purfid
purify = purfi
purifying = purfig
purity = purt
purple = prpl
purpose = prps
purposeful = prpsf
purposes = prpss
pursue = psu
pursued = psud
pursues = psuss
pursuing = psug
pursuit = psut
pursuits = psuts
push = pus
pushed = pusd
pushes = puss
pushing = pusg
put = pt
puts = pts
putting = ptg
puzzle = pzl
puzzled = pzld
puzzles = pzls
puzzling = pzlg
pyramid = prmd
pyramids = prmds
quake = qak
qualification = qlfcz
qualifications = qlfczs
qualified = qlfid
qualifiers = qlfrs
qualifies = qlfis
qualify = qlfi
qualities = qlts
quality = qlt
quantities = qntts
quantity = qntt
quantum = qntm
quarrel = qrl
quarreled = qrld
quarreling = qrlg
quarrels = qrls
quarter = qrtr
quarters = qrtrs
queen = qen
queens = qens
quest = qst
question = q
questioned = qd
questioning = qg
questions = qs
quests = qsts
quibble = qbl
quick = qk
quicker = qkr
quickest = qkst
quickly = qkl
quiet = qiet
quieted = qietd
quieter = qietr
quietest = qietst
quieting = qietg
quietly = qietl
quirk = qrk
quirks = qrks
quirky = qrke
quit = qt
quite = qit
quits = qts
quitting = qtg
quiz = qz
quote = qot
quotes = qots
quotient = qosnt
race = rac
raced = racd
races = racs
racing = racg
rack = rk
racket = rkt
radar = radr
radiate = radt
radiated = radtd
radiates = radts
radiation = radz
radical = rdcl
radically = rdcll
radio = rado
radioactive = radactv
radios = rados
raft = rft
rafts = rfts
rage = raj
raged = rajd
rages = rajs
raging = rajg
raid = rad
raided = radd
raiding = radg
raids = rads
rail = ral
railed = rald
railroad = ralrd
railroads = ralrds
rails = rals
rain = ran
rained = rand
raining = rang
rains = rans
rainy = rane
raise = raz
raised = razd
raises = razs
raising = razg
rake = rak
rakes = raks
rallies = rales
rally = rale
ram = ram
ramble = rmbl
rambled = rmbld
rambling = rmblg
ramifications = rmfczs
ramp = rmp
ramped = rmpd
ramping = rmpg
ramps = rmps
rams = rams
ran = rn
ranch = rnc
ranches = rncs
rancor = rncr
random = rndm
rang = rng
range = rnj
ranges = rnjs
rank = rnk
ranking = rnkg
ranks = rnks
rapid = rpid
rapidly = rpidl
rare = rar
rarely = rarl
rat = ratt
ratchet = rtct
ratcheted = rtctd
ratcheting = rtctg
rate = rat
rated = ratd
rates = rats
rather = rtr
rating = ratg
rational = rsnl
rationale = razal
rationalize = rsnlz
rationally = rsnll
rats = ratts
rattle = rtl
rattled = rtld
rattles = rtls
rattling = rtlg
rave = rav
raved = ravd
raves = ravs
raving = ravg
raw = rw
ray = ra
rays = ras
razor = rzr
razors = rzrs
reach = rec
reached = recd
reaches = recs
reaching = recg
react = ract
reacted = ractd
reacting = ractg
reaction = racz
reactions = raczs
reactive = ractv
reacts = racts
read = red
readable = redb
reader = redr
readers = redrs
readied = rded
readily = rdel
readiness = rdns
reading = redg
readings = redgs
reads = reds
ready = rde
readying = rdeg
reaffirm = rafirm
real = rel
realist = relst
realistic = relstc
realistically = relstcl
realities = relts
reality = relt
realization = rlzz
realizations = rlzzs
realize = rlz
realized = rlzd
realizes = rlzs
realizing = rlzg
really = rell
realm = rlm
ream = rem
reap = rep
reaped = repd
reaping = repg
reaps = reps
rear = rer
reared = rerd
rearing = rerg
reason = rsn
reasonable = rsnb
reasoned = rsnd
reasoning = rsng
reasons = rsns
reassurance = rasurnc
reassure = rasur
reassured = rasurd
reassuring = rsurg
rebel = rbel
rebelled = rbeld
rebelling = rbelg
rebellion = rbeln
rebellious = rbelus
rebels = rbels
rebirth = rbrt
reborn = rborn
rebound = rbond
rebuild = rbld
rebuilding = rbldg
rebuilds = rblds
rebuilt = rblt
recall = rcal
recalls = rcals
recapture = rcptur
recaptured = rcpturd
recede = rced
recedes = rceds
receding = rcedg
receipt = rcpt
receipts = rcpts
receive = rcev
received = rcevd
receives = rcevs
receiving = rcevg
recent = rcnt
recently = rcntl
receptacle = rcptcl
reception = rcpz
receptive = rcptv
receptivity = rcptvt
recharge = rcrj
recipe = rcpe
recipient = rcpnt
recipients = rcpnts
reciprocate = rcproct
recite = rcit
recited = rcitd
reciting = rcitg
reckless = rkls
reckon = rkn
reckoned = rknd
reclaim = rclam
recline = rclin
reclined = rclind
reclines = rclins
reclining = rcling
recluse = rclus
recognition = rcgnzz
recognizable = rcgnzb
recognize = rcgnz
recognized = rcgnzd
recognizes = rcgnzs
recognizing = rcgnzg
recollect = rclct
recommend = rcmnd
recommendation = rcmndz
recommendations = rcmndzs
recommended = rcmndd
reconcile = rcncil
reconciliation = rccilz
reconsider = rcsdr
reconstruct = rcstrct
record = rcrd
recorded = rcrdd
recorder = rcrdr
recorders = rcrdrs
recording = rcrdg
recordings = rcrdgs
records = rcrds
recount = rcont
recourse = rcors
recover = rcv
recovered = rcvd
recovering = rcvg
recovery = rcvr
recreate = rcret
recreates = rcrets
recreating = rcretg
recreation = rcrez
recriminations = rcrmnzs
recruit = rcrut
recruited = rcrutd
rectify = rctfi
rectifying = rctfig
recuperate = rcuprt
recur = rcur
recurrent = rcrnt
red = rd
redirect = rdrct
redirected = rdrctd
rediscover = rdscv
reduce = rduc
reduced = rducd
reduces = rducs
reducing = rducg
reduction = rducz
reed = reed
reestablish = restbls
reexamined = rxmnd
refer = rfr
reference = rfrnc
references = rfrncs
referendum = rfrndm
referral = rfral
referred = rfrd
referring = rfrg
refers = rfrs
refill = rfl
refilled = rfld
refilling = rflg
refills = rfls
refine = rfin
refined = rfind
refinement = rfinm
refinements = rfinms
refines = rfins
refining = rfing
reflect = rflct
reflected = rflctd
reflecting = rflctg
reflection = rflcz
reflections = rflczs
reflective = rflctv
reflects = rflcts
reflex = rflx
reflexes = rflxs
refocus = rfocs
reform = rfrm
reformed = rfrmd
reforming = rfrmg
reforms = rfrms
refract = rfrct
refracted = rfrctd
refracting = rfrctg
refracts = rfrcts
refrain = rfran
refrained = rfrand
refraining = rfrang
refrains = rfrans
reframe = rfram
refresh = rfres
refreshed = rfresd
refreshes = rfress
refreshing = rfresg
refreshment = rfresm
refuge = rfuj
refugee = rfug
refugees = rfugs
refuges = rfujs
refund = rfnd
refunded = rfndd
refunding = rfndg
refunds = rfnds
refurbish = rfrbs
refurbished = rfrbsd
refurbishing = rfrbsg
refuse = rfus
refused = rfusd
refuses = rfuss
refusing = rfusg
regain = rgan
regained = rgand
regaining = rgang
regains = rgans
regard = rgrd
regarded = rgrdd
regarding = rgrdg
regardless = rgrdls
regards = rgrds
regenerate = rgnrt
regenerated = rgnrtd
regenerating = rgnrtg
region = rjn
regional = rjnl
regions = rjns
register = rjstr
registered = rgstrd
registering = rgstrg
registers = rgstrs
registration = rjstrz
regressed = rgrsd
regret = rgrt
regrets = rgrts
regretted = rgrtd
regretting = rgrtg
regular = rglr
regularity = rglrt
regularly = rglrl
regulate = rgult
regulates = rglts
regulation = rglz
regulations = rglzs
rehearsal = rhrsl
rehearsals = rhrsls
rehearse = rhrs
rehearsing = rhrsg
reign = ren
reigned = rend
reigns = rens
reinforce = rnfrc
reinforced = rnfrcd
reinforcement = rnfrcm
reinforces = rnfrcs
reinforcing = rnfrcg
reinvent = rnvnt
reinventing = rnvntg
reinvigorate = rnvgrt
reject = rjct
rejected = rjctd
rejecting = rjctg
rejection = rjcz
rejects = rjcts
rejoice = rjyc
rejoicing = rjycg
rejuvenate = rjvnt
rejuvenation = rjvnz
relate = rlat
related = rlatd
relates = rlats
relating = rlatg
relation = rlaz
relations = rlazs
relationship = rlazzp
relationships = rlazzps
relative = rltv
relatively = rltvl
relatives = rltvs
relax = rlx
relaxation = rlxz
relaxed = rlxd
relaxes = rlxs
relaxing = rlxg
relay = rla
relays = rlas
release = rles
released = rlesd
releases = rless
releasing = rlesg
relegate = rlgt
relegated = rlgtd
relegates = rlgts
relentless = rlntls
relentlessly = rlntlsl
relevance = rlvnc
relevant = rlvnt
reliability = rlibt
reliable = rlib
reliance = rlinc
reliant = rlint
relied = rlid
relief = rlef
relies = rlis
relieve = rlev
relieved = rlevd
relieves = rlevs
relieving = rlevg
religion = rljn
religious = rljus
relish = rels
relishes = relss
relishing = relsg
reluctance = rlctnc
reluctant = rlctnt
reluctantly = rlctntl
rely = rli
relying = rlig
remain = rman
remained = rmand
remaining = rmang
remains = rmans
remark = rmrk
remarkable = rmrkb
remarkably = rmrkbl
remarks = rmrks
remedied = rmdd
remedies = rmds
remedy = rmd
remember = rmbr
remembered = rmbrd
remembering = rmbrg
remembers = rmbrs
remembrance = rmbrnc
remind = rmnd
reminded = rmndd
reminder = rmndr
reminders = rmndrs
reminding = rmndg
reminds = rmnds
reminisce = rmns
remiss = rmis
remnant = rmnnt
remnants = rmnts
remorse = rmors
remorseful = rmorsf
remote = rmot
remotely = rmotl
removable = rmvb
removal = rmvl
remove = rmv
removed = rmvd
removes = rmvs
removing = rmvg
renew = rnu
renewal = rnul
renewed = rnud
renews = rnus
renovation = rnovz
rent = rent
rents = rents
reorganize = rorgnz
reorient = rornt
repair = rpar
repaired = rpard
repairing = rparg
repairs = rpars
repeat = rpet
repeated = rpetd
repeatedly = rpetdl
repeating = rpetg
repeats = rpets
repelled = rpld
repertory = rprtor
repetition = rptz
repetitions = rptzs
repetitious = rptsus
repetitive = rpttv
replace = rplc
replaceable = rplcb
replaced = rplcd
replacement = rplcm
replaces = rplcs
replacing = rplcg
replenish = rplns
replenished = rplnsd
replenishing = rplnsg
replica = rplca
replicate = rplct
replicated = rplctd
replicates = rplcts
replicating = rplctg
replication = rplcz
replied = rplid
replies = rplis
reply = rpli
replying = rplig
report = rprt
reported = rprtd
reportedly = rprtdl
reporter = rprtr
reporting = rprtg
reports = rprts
reposition = rposz
represent = rprsnt
representation = rprsntz
representative = rpsntv
representatives = rprsnttvs
represented = rprsntd
representing = rpsntg
represents = rprsnts
repressed = rprsd
repression = rprz
reprieve = rprev
reprieved = rprevd
reprimand = rprmnd
reproach = rproc
reproached = rprocd
reproaches = rprocs
reproaching = rprocg
reproduce = rpduc
reproduced = rpducd
reproduces = rpducs
reproducing = rpducg
reproduction = rprdcz
repugnant = rpgnnt
repulsive = rplsv
repute = rput
request = rcst
requested = rcstd
requesting = rcstg
requests = rcsts
require = rcir
required = rcird
requirement = rcirm
requirements = rcirms
requires = rcirs
requiring = rcirg
rescue = rscu
rescued = rscud
rescues = rscus
research = rsrc
researched = rsrcd
researching = rsrcg
resemble = rsmbl
resembles = rsmbls
resembling = rsmblg
resent = rsnt
resentful = rsntf
resentment = rsntm
resents = rsnts
reservation = rsrvz
reservations = rsrvzs
reserve = rsrv
reserved = rsrvd
reserves = rsrvs
reserving = rsrvg
reservoir = rsrvr
reservoirs = rsrvrs
reside = rsid
resident = rsdnt
residents = rsdnts
resides = rsids
residing = rsidg
residual = rsdul
residue = rsdu
resign = rsin
resigned = rsind
resilience = rslnc
resilient = rslnt
resist = rsst
resistance = rsstnc
resistant = rsstnt
resisted = rsstd
resisting = rsstg
resists = rssts
resolution = rsolz
resolve = rsolv
resolved = rsolvd
resolves = rsolvs
resolving = rsolvg
resonance = rsnnc
resonate = rsont
resort = rsrt
resorting = rsrtg
resource = rsorc
resourceful = rsorcf
resources = rsorcs
respect = rspct
respected = rspctd
respectfully = rspctfll
respective = rspctv
respectively = rspctvl
respects = rspcts
respond = rspnd
responded = rspndd
responding = rspndg
responds = rspnds
response = rspns
responses = rspnss
responsibilities = rspsnbts
responsibility = rspnsbt
responsible = rspnsb
responsive = rspnsv
rest = rst
rested = rstd
restful = rstf
resting = rstg
restoration = rstraz
restore = rstor
restored = rstord
restrain = rstran
restrained = rstrand
restraining = rstrang
restraint = rstrant
restraints = rstrnts
restrict = rstrct
restricted = rstrctd
restricting = rstrctg
restriction = rstrcz
restrictions = rstrczs
rests = rsts
result = rslt
resulted = rsltd
resulting = rsltg
results = rslts
resume = rsum
resuscitate = rsstt
retail = rtal
retain = rtan
retained = rtand
retaining = rtang
retains = rtans
retire = rtir
retired = rtird
retirement = rtirm
retiring = rtirg
retort = rtort
retrace = rtrac
retracing = rtrcg
retract = rtrct
retracting = rtrctg
retraction = rtrctz
retreat = rtret
retreats = rtrets
retrieve = rtrev
retrieved = rtrevd
retrieves = rtrevs
retrospect = rtrspct
return = rtrn
returned = rtrnd
returning = rtrng
returns = rtrns
revamp = rvmp
revamped = rvmpd
reveal = rvel
revealed = rveld
revealing = rvelg
reveals = rvels
revelation = rvlz
revelations = rvlzs
revenge = rvnj
revenue = rvnu
revenues = rvnus
reverberate = rvrbrt
reverberating = rvrbrtg
reverence = rvrnc
reverent = rvrnt
reverie = rvre
reverse = rvers
reversed = rvrsd
reversing = revrsg
revert = rvrt
reverted = rvrtd
reverts = rvrts
review = rvw
reviewed = rvwd
reviewing = rvwg
reviews = rvws
revise = rvz
revising = rvzg
revision = rvzz
revisions = rvzzs
revitalization = rvitlzz
revitalize = rvitlz
revive = rvv
revived = rvvd
revives = rvvs
revocation = rvocz
revoke = rvok
revoked = rvokd
revokes = rvoks
revolt = rvlt
revolution = rvluz
revolutionary = rvluzr
revolutionize = rvlusnz
revolve = rvlv
revolves = rvlvs
revulsion = rvulz
reward = rwd
rewarded = rwdd
rewarding = rwdg
rewards = rwds
rewrite = rrit
rewriting = rritg
rewritten = rrtn
rhyme = rim
rhythm = rtm
rhythms = rtms
rib = rb
ribbed = rbd
ribbing = rbg
ribbon = rbn
ribbons = rbns
rice = ric
rich = rc
richer = rcr
riches = rcs
richness = rcns
rid = rdd
riddance = rddnc
ridden = rdn
riddle = rdl
riddles = rdls
ride = rid
rider = ridr
rides = rids
ridicule = rdcul
ridiculous = rdclus
riding = ridg
rifle = rifl
rifles = rifls
right = rt
righteous = ritus
rights = rts
rigid = rjd
rigidly = rjdl
rigorous = rgrus
rigors = rgrs
ring = rg
rings = rgs
riot = riot
rip = ripp
ripe = rip
ripple = rpl
ripples = rpls
rise = rz
risen = rzn
rises = rzs
rising = rzg
risk = rsk
risks = rsks
risky = rske
ritual = rtul
rival = rivl
river = rvr
rivers = rvrs
road = rod
roads = rods
roam = rom
roamed = romd
roaming = romg
roar = ror
roared = rord
roaring = rorg
roars = rors
roast = rost
roasted = rostd
roasting = rostg
roasts = rosts
rob = rob
robbed = robd
robbing = robg
robs = robs
robust = rbst
rock = rok
rocket = rokt
rockets = rokts
rocks = roks
rocky = roke
rode = rode
rodent = rodnt
rodents = rodnts
role = rol
roles = rols
roll = rl
rolled = rld
rolling = rlg
rolls = rls
romantic = rmntc
roof = rof
roofs = rofs
room = rm
rooms = rms
root = rot
rooted = rotd
roots = rots
rope = rop
ropes = rops
rose = roz
roses = rozs
rotate = rott
rotation = rotaz
rough = ruf
round = rnd
rounded = rndd
route = rut
routes = ruts
routine = rutin
routines = rutns
row = ro
rows = ros
royal = ryl
royally = ryll
rub = rub
rubbed = rubd
rubber = rubr
rubble = rubl
rude = rud
rudely = rudl
rudimentary = rudmntr
ruffle = rufl
ruffled = rufld
ruffles = rufls
ruin = ruin
ruined = ruind
ruining = ruing
ruins = ruins
rule = rul
ruled = ruld
ruler = rulr
rules = ruls
rumor = rumr
rumored = rumrd
rumors = rmrs
run = run
rung = rungg
runner = runr
runners = runrs
running = rung
runs = runs
rupture = rptr
ruptured = rptrd
rural = rurl
rush = rus
rushed = rusd
rushes = russ
rushing = rusg
Russian = rusn
rustic = rstc
rusty = rste
rut = rutt
ruts = rutss
sabotage = sbotj
sabotaged = sbotjd
sacred = sacrd
sacrifice = scrfc
sacrificed = scrfcd
sacrificing = scrfcg
sad = sd
saddened = sdnd
saddest = sdst
saddle = sadl
saddled = sadld
sadly = sdl
sadness = sdns
safe = saf
safely = safl
safer = safr
safest = safst
safety = saft
said = sad
sail = sail
sailed = saild
sailing = sailg
sailor = sailr
sailors = sailrs
sake = sak
salad = sald
salads = salds
salaries = slrs
salary = slr
sale = sal
sales = sals
salt = slt
salvage = slvj
salvaged = salvjd
salvation = slvz
same = sam
sample = samp
sampled = smpd
samples = smps
sampling = smpg
sand = sand
sanded = sandd
sanding = sandg
sands = sands
sandwich = sndwc
sandy = snde
sang = sang
Santa = snta
sash = sas
sashes = sass
sat = satt
satellite = stlit
satisfaction = stsfcz
satisfactions = stsfczs
satisfactory = stsfctr
satisfied = stsfid
satisfies = stsfis
satisfy = stsfi
satisfying = stsfig
saturate = sturt
saturated = sturtd
saturates = sturts
saturation = strz
Saturday = sat
save = sav
saved = savd
saves = savs
saving = savg
savings = savgs
savor = savr
savored = savrd
savoring = savrg
savors = savrs
saw = sw
saws = sws
say = sa
saying = sag
says = ss
scale = scal
scaled = scald
scales = scals
scan = scan
scanned = scand
scanning = scang
scans = scans
scarcely = scrcl
scare = scar
scared = scard
scares = scars
scarf = scrf
scary = scare
scatter = sctr
scattered = sctrd
scattering = sctrg
scatters = sctrs
scene = scen
scenery = scenr
scenes = scens
scent = scnt
scents = scnts
schedule = scdl
scheduled = scdld
schedules = scdls
scheduling = scdlg
scheme = scem
schemed = scemd
schemes = scems
scheming = scemg
school = scol
schools = scols
science = sinc
scientific = sintfc
scientist = sintst
scientists = sintsts
scope = scop
score = scor
scored = scord
scores = scors
scoring = scorg
scrap = scrp
scrape = scrap
scraped = scrapd
scraping = scrapg
scraps = scrps
scratch = scrc
scratched = scrcd
scratches = scrcs
scratching = scrcg
scream = screm
screamed = scremd
screaming = scremg
screams = screms
screech = screc
screeched = screcd
screeching = screcg
screen = scren
screens = screns
screw = scru
screwing = scrug
screws = scrus
scroll = scrol
scrub = scrb
scruple = scrpl
scruples = scrpls
scrutinize = scrutnz
scrutinized = scrutnzd
scrutiny = scrutn
sculpture = sclptr
scurry = scure
sea = sea
seal = sel
sealed = seld
seamless = semls
search = src
searched = srcd
searches = srcs
searching = srcg
seas = seas
season = sesn
seasons = sesns
seat = set
seated = setd
seats = sets
secluded = scludd
second = scnd
secondary = scndr
secondly = scndl
seconds = scnds
secret = scrt
secretarial = scrtrl
secretary = scrtr
secretly = scrtl
secrets = scrts
section = scz
sections = sczs
secure = scur
secured = scurd
securely = scurl
secures = scurs
securing = scurg
security = scurt
sedate = sdat
seduce = sduc
see = se
seed = sed
seeds = seds
seeing = seg
seek = sek
seeking = sekg
seeks = seks
seem = sem
seemed = semd
seems = sems
seen = sen
sees = ses
segment = sgm
seize = sez
seized = sezd
seizes = sezs
seizing = sezg
seldom = sldm
select = slct
selected = slctd
selecting = slctg
selection = slcz
selections = slczs
selective = slctv
selects = slcts
self = sf
selfish = sfs
selfishness = sfsns
sell = sl
selling = slg
sells = sls
semblance = smblnc
semester = smstr
semesters = smstrs
senate = snat
send = snd
sending = sndg
sends = snds
sensation = snsz
sensations = snszs
sense = sns
sensed = snsd
senses = snss
sensibilities = snsbts
sensible = snsb
sensing = snsg
sensitive = snstv
sensitivity = snstvt
sensual = snsul
sent = sent
sentence = sntnc
sentences = sntncs
sentiment = sntm
sentimental = sntml
separate = seprt
separated = seprtd
separately = seprtl
separates = seprts
separating = seprtg
separation = seprz
separations = seprzs
September = sep
sequence = scnc
sequences = scncs
sequencing = scncg
sequential = scnsl
sequentially = scnsll
serene = sren
serenity = srnt
series = seres
serious = srus
seriously = srusl
seriousness = srusns
servant = srvnt
serve = srv
served = srvd
serves = srvs
service = srvc
services = srvcs
serving = srvg
session = ssz
sessions = sszs
set = st
setback = stbk
setbacks = stbks
sets = sts
setting = setg
settings = setgs
settle = setl
settled = setld
settlement = setlm
settlers = setlrs
settles = setls
settling = setlg
seven = svn
seventy = svnte
several = svrl
severe = sver
severely = sverl
severity = svert
sex = sx
sexual = sxl
shade = zad
shaded = zadd
shades = zads
shading = zadg
shadow = zdo
shadowed = zdod
shadowing = zdog
shadows = zdos
shake = zak
shaken = zakn
shakes = zaks
shaking = zakg
shall = zal
shallow = zalo
shame = zam
shamed = zamd
shames = zams
shaming = zamg
shape = zap
shaped = zapd
shapes = zaps
shaping = zapg
share = zar
shared = zard
shares = zars
sharing = zarg
sharp = zrp
sharpen = zrpn
sharpened = zrpnd
sharpening = zrpng
sharpens = zrpns
sharper = zrpr
sharpest = zrpst
sharply = zrpl
sharpness = zrpnes
shave = zav
shaved = zavd
shaven = zavn
shaves = zavs
she = ze
shear = zear
sheared = zeard
shearing = zearg
shears = zers
shed = zed
sheer = zer
sheet = zet
sheets = zets
shelf = zlf
shell = zl
shells = zls
shelter = zltr
shield = zeld
shift = zft
shifted = zftd
shifting = zftg
shifts = zfts
shimmer = zmr
shimmering = zmrg
shine = zin
shines = zins
shining = zing
shiny = zine
ship = zp
shipment = zpm
shipments = zpms
shipped = zpd
shipping = zpg
ships = zps
shirk = zrk
shirt = zirt
shock = zok
shocked = zokd
shocking = zokg
shoe = zu
shoes = zus
shook = zk
shoot = zoot
shooting = zootg
shop = zop
shopping = zopg
shops = zops
shore = zr
short = zrt
shortage = zrtj
shortcoming = zrtcmg
shortcomings = zrtcmgs
shortcut = zrtct
shortcuts = zrtcts
shorten = zrtn
shortening = zrtng
shorter = zrtr
shortest = zrtst
shorthand = zrthnd
shortly = zrtl
shot = zot
shots = zots
should = zd
shoulder = zldr
shoulders = zldrs
shouldn't = zdnt
shout = zwt
shouted = zwtd
shouting = zwtg
shove = zov
shoved = zovd
shovel = zvl
shovels = zvls
shoving = zovg
show = zo
showed = zod
shower = zor
showering = zorg
showers = zors
showing = zog
shown = zon
shows = zos
shreds = zrds
shrink = zrnk
shrinking = zrnkg
shrouded = zrwdd
shrug = zrug
shrugged = zrugd
shudder = zudr
shuffle = zfl
shuffled = zfld
shuffling = zuflg
shun = zun
shut = zt
shuts = zts
shutting = ztg
shy = zi
sick = sk
sickening = skng
side = sid
sided = sidd
sidelines = sidlins
sides = sids
sidetrack = sidtrk
sidetracked = sidtrkd
sigh = si
sighed = sigd
sight = sit
sights = sits
sign = sin
signal = sgnl
signals = sgnls
signature = sgntr
signed = sind
significance = sgnfcnc
significant = sgnfcnt
significantly = sgnfcntl
signify = sgnfi
signing = sing
signs = sins
silence = silnc
silent = silnt
silently = silntl
silk = slk
silliness = silns
silly = sil
silver = slvr
similar = simlr
similarities = smlrts
similarity = smlrt
similarly = smlrl
simmer = simr
simmered = simrd
simmering = simrg
simmers = simrs
simple = smp
simpler = smpr
simplest = smpst
simplicity = smpct
simplification = smpfcz
simplified = smpfid
simplify = smpfi
simplistic = smpstc
simply = smpl
simultaneous = smltnus
simultaneously = smltnusl
sin = snn
since = snc
sincere = sncr
sincerely = sncl
sincerity = sncrt
sing = sg
singing = sgg
single = sgl
sings = sgs
sink = snk
sinking = snkg
sinks = snks
siphon = sifn
siphoned = sifnd
siphoning = sifng
siphons = sifns
sir = sr
sister = sstr
sisters = sstrs
sit = stt
site = site
sits = stts
sitting = sttg
situation = stuz
situations = stuzs
six = six
sixth = sxt
sixty = sixte
sizable = szb
size = sz
sized = szd
sizes = szs
sizzle = szl
sizzled = szld
sizzles = szls
sizzling = szlg
skate = skat
skated = skated
skates = skats
skating = skatg
skeleton = skltn
skeletons = skltns
skeptical = skptcl
sketch = skc
sketched = skcd
sketches = skcs
sketching = skcg
ski = skii
skied = skiid
skies = skis
skiing = skiig
skill = skl
skilled = skld
skillful = sklf
skillfully = sklfl
skills = skls
skim = skm
skimmed = skimd
skimming = skmg
skimp = skmp
skimped = skmpd
skimpy = skmpe
skims = skms
skin = skn
skinned = sknd
skins = skns
skip = skp
skipped = skpd
skipping = skpg
skips = skps
skirt = skrt
skirting = skrtg
skirts = skrts
skis = skiis
skull = skul
skulls = skuls
sky = ski
slack = slak
slacked = slakd
slacken = slakn
slackened = slaknd
slacking = slakg
slam = slm
slammed = slmd
slamming = slmg
slams = slms
slander = slandr
slant = slnt
slants = slnts
slap = slap
slapped = slapd
slapping = slapg
slate = slat
slave = slav
slavery = slavr
slaves = slavs
sleep = slep
sleeping = slepg
sleeps = sleps
sleepy = slepe
sleeve = slev
sleeves = slevs
slender = slndr
slept = slpt
slice = slic
slick = slik
slid = sldd
slide = slid
slides = slids
sliding = slidg
slight = slit
slightest = slitst
slightly = slitl
sling = sling
slip = slp
slipped = slpd
slipping = slpg
slips = slps
sloop = sloop
sloops = sloops
slope = slop
slopes = slops
slow = slo
slowdown = slodw
slowed = slod
slower = slor
slowest = slost
slowing = slog
slowly = slol
slowness = slons
slows = slos
slump = slmp
sly = sli
smack = smk
small = sml
smaller = smlr
smallest = smlst
smart = smrt
smarter = smrtr
smartest = smrtst
smarting = smrtg
smartly = smrtl
smarts = smrts
smash = smas
smell = smel
smile = smil
smiled = smild
smiling = smilg
smoke = smok
smoking = smokg
smoldering = smldrg
smooth = smot
smoother = smotr
smoothest = smotst
smoothly = smotl
smoothness = smotns
snake = snak
snakes = snaks
snap = snp
snapped = snpd
snapping = snpg
snappy = snpe
sneak = snek
sneeze = snez
snow = sno
so = so
soak = soak
soap = soap
soar = sor
soaring = sorg
soars = sors
sober = sobr
social = socl
society = socit
soft = sft
soften = sfn
softer = sftr
softest = sftst
softly = sftl
softness = sftns
software = sftwr
soil = syl
soiled = syld
soiling = sylg
soils = syls
solar = solr
sold = sld
soldier = sldr
soldiers = soldrs
sole = sol
solely = soll
solemn = solm
solid = sold
solidarity = soldrt
solidify = soldfi
solitary = soltr
solitude = soltud
solution = solz
solutions = solzs
solve = solv
solved = solvd
solvents = solvnts
solves = solvs
solving = solvg
somber = smbr
some = sm
somebody = smbd
someday = smda
somehow = smhw
someone = smon
someplace = smplc
something = smg
sometime = smtm
sometimes = smtms
somewhat = smwt
somewhere = smwr
son = sn
song = sng
songs = sngs
sons = sons
soon = son
sooner = sonr
soothe = sooth
soothing = sotg
sophisticated = sfstctd
sophistication = sfstcz
sordid = srdd
sorrow = soro
sorry = sore
sort = srt
sorted = srtd
sorting = srtg
sorts = srts
sought = sout
soul = soul
sound = sond
sounded = sondd
sounding = sondg
soundly = sondl
soundness = sondns
sounds = sonds
soup = sup
sour = sour
source = sorc
sources = sorcs
south = sot
Southern = sotrn
sovereign = sovrn
space = spc
spaced = spcd
spaces = spcs
spacing = spcg
Spanish = spns
spare = spar
spark = sprk
sparkle = sprkl
sparks = sprks
spasm = spsm
spasms = spsms
speak = spek
speaker = spekr
speaking = spekg
speaks = speks
special = spcl
specialize = spclz
specialized = spclzd
specializes = spclzs
specially = spcll
specialty = spclt
species = speces
specific = spcfc
specifically = spcfcl
specification = spcfcz
specifications = spcfczs
specifics = spcfcs
specified = spcfid
specifies = specfis
specify = spcfi
specifying = spcifg
specimen = spcmn
spectacle = spctcl
spectacles = spctcls
spectacular = spctclr
spectrum = spctrm
speculate = spcult
speculation = spculz
speech = spec
speeches = specs
speed = sped
speeded = spedd
speeding = spedg
speeds = speds
speedy = spede
spell = spel
spelled = speld
spelling = spelg
spells = spels
spend = spnd
spending = spndg
spends = spnds
spent = spnt
sphere = sfer
spider = spidr
spies = spis
spike = spik
spiked = spikd
spikes = spiks
spiking = spikg
spill = spil
spilled = spld
spills = spils
spin = spn
spinal = spinl
spinning = spng
spirit = spirt
spirits = spirts
spiritual = spirtl
spit = spt
spite = spit
spiteful = spitf
spits = spts
splash = spls
splashed = splsd
splashes = splss
splashing = splsg
splatter = spltr
splattered = spltrd
splattering = spltrg
splatters = spltrs
splendid = splndd
splendor = splndr
splendors = splndrs
splice = splic
spliced = splicd
splices = splics
splicing = splicg
split = splt
splits = splts
splitting = spltg
spoil = spyl
spoiled = spyld
spoiling = spylg
spoils = spyls
spoke = spok
spoken = spokn
sponsor = spnsr
sponsored = spnsrd
spontaneous = spntnus
spontaneously = spntnusl
spook = spk
spooked = spkd
spooking = spkg
sport = sprt
sporting = sprtg
sports = sprts
spot = spot
spots = spots
spotted = spotdd
sprang = sprag
spread = sprd
spreading = sprdg
spreads = sprds
spring = sprg
springing = sprgg
springs = sprgs
sprinkle = sprnkl
sprint = sprnt
sprung = sprng
spurred = spurd
spurring = spurg
spy = spi
squandered = scndrd
square = scr
squarely = scrl
squares = scrs
squash = scas
squashed = scasd
squashes = scass
squashing = scasg
squeeze = scez
squeezed = sczd
squeezing = sczg
squirm = scrm
stab = stb
stabbed = stbd
stabbing = stbg
stability = stblt
stabilize = stbz
stabilized = stbzd
stable = stab
staccato = stcto
stack = stk
stacked = stkd
stacks = stks
staff = staf
staffs = stafs
stage = stj
staged = stjd
stages = stjs
staging = stjg
stagnant = stgnnt
stagnate = stgnt
stagnation = stgnz
stain = stan
stained = stand
staining = stang
stains = stans
stair = stair
stairs = stars
stake = stak
stakes = staks
staking = stakg
stale = stal
stamina = stmna
stammer = stmr
stammered = stmrd
stammering = stmrg
stammers = stmrs
stamp = stmp
stamped = stmpd
stamping = stmpg
stamps = stmps
stance = stnc
stand = stnd
standard = stndrd
standards = stndrds
standing = stndg
standpoint = stndpnt
standpoints = stndpnts
stands = stnds
standstill = stndstl
staples = stapls
star = str
stare = star
stared = stard
staring = starg
stars = strs
start = strt
started = strtd
starting = strtg
startle = strtl
startled = strtld
startling = strtlg
starts = strts
starve = strv
starving = strvg
state = stat
stated = statd
statement = statm
statements = statms
states = stats
static = sttc
station = stz
stationary = stazr
stationed = stzed
stationing = stzg
stations = stazs
statistic = sttstc
statistics = sttstcs
statue = sttu
statues = sttus
status = status
stay = sta
stayed = stad
staying = stag
stays = stas
steadfast = stdfst
steadily = stdl
steady = std
steal = stel
steals = stels
stealth = stelt
steam = stem
steel = steel
steep = step
steer = ster
steered = sterd
steering = sterg
steers = sters
stem = stm
stems = stms
step = stp
stepped = stpd
stepping = stpg
steps = stps
stern = strn
stick = stik
sticking = stikg
sticks = stiks
sticky = stike
stiff = stf
stiffness = stfns
stifled = stifld
still = stl
stillness = stlns
stimulate = stmlt
stimulated = stmltd
stimulates = stmlts
stimulating = stmultg
stimulation = stmlz
stimulus = stmlus
sting = stg
stinging = stgg
stingy = stnj
stir = stir
stirred = stird
stitch = stc
stitches = stcs
stock = stok
stockpile = stokpil
stocks = stoks
stolen = stoln
stomach = stmc
stone = ston
stones = stons
stood = stod
stop = stop
stopped = stopd
stopping = stopg
stops = stops
storage = strj
store = stor
stored = stord
stores = stors
stories = stores
storing = storg
storm = strm
stormed = strmd
storms = strms
stormy = strme
story = store
stove = stov
straight = strat
straighten = stratn
straightened = stratnd
straightening = stratng
strain = stran
strained = strand
straining = strang
strains = strans
strange = strnj
strangely = strnjl
stranger = strnjr
strangers = strnjrs
strap = strap
strapped = strapd
strapping = strapg
straps = straps
strategic = stratgc
strategically = stratgcl
strategies = stratgs
strategy = stratg
straw = strw
straws = strws
stray = stra
strayed = strad
straying = strag
strays = stras
streak = strek
streaking = strekg
streaks = streks
stream = strem
streamed = stremd
streaming = stremg
streamline = stremlin
streamlined = strmlind
streams = strems
street = stret
streets = strets
strength = strngt
strengthen = strngtn
strengths = strngts
strenuous = strnus
stress = stres
stressed = stresd
stresses = stress
stressful = stresf
stressing = stresg
stretch = strc
stretched = strcd
stretches = strcs
stretching = strcg
strict = strct
stride = strid
strides = strids
strife = strif
strike = strik
strikes = striks
striking = strikg
string = strg
stringent = strnjnt
stringing = strgg
strings = strgs
strip = strp
stripping = strpg
strips = strps
strive = striv
striving = strivg
stroke = strok
strokes = stroks
stroking = strokg
stroll = strol
strolling = strolg
strolls = strols
strong = strng
stronger = strngr
strongest = strngst
strongly = strngl
struck = strk
structure = strctr
structured = strctrd
structures = strctrs
struggle = strgl
struggled = strgld
struggles = strgls
struggling = strglg
stubborn = stbrn
stuck = stuk
student = studnt
students = stdts
studied = studd
studies = studs
study = stud
studying = studg
stuff = stuf
stuffing = stufg
stumble = stmbl
stumbled = stmbld
stumbling = stmblg
stumped = stumpd
stun = stn
stunned = stund
stunning = stng
stunningly = stungl
stuns = stuns
stunt = stnt
stunted = stntd
stupid = stupd
stupidity = stpdt
stupidly = stupdl
sturdiness = sturdns
sturdy = strd
stutter = sttr
style = stil
styles = stils
subconscious = sbcsus
subject = sbjct
subjective = sbjctv
subjects = sbjcts
sublime = sblim
submerge = sbmrj
submerged = sbmrjd
submersed = sbmrsd
submit = sbmt
submits = sbmts
submitted = sbmtd
submitting = sbmtg
subscription = sbscpz
subscriptions = sbscpzs
subside = sbsid
subsided = sbsidd
subsides = sbsids
subsiding = sbsidg
substance = sbstnc
substances = sbstncs
substantial = sbstnsl
substitute = sbstt
substituted = sbsttd
substitutes = sbstts
substituting = sbsttg
substitution = sbsttz
subtle = sutl
subtleties = sutlts
subtract = sbtrct
subtracted = sbtrctd
subtracting = sbtrctg
succeed = scd
succeeded = scdd
succeeding = scdg
succeeds = scds
success = scs
successes = scss
successful = scsf
successfully = scsfl
succession = scsz
successive = scsv
succinct = sccnt
succulent = sculnt
such = sc
suck = suk
sucked = skd
sucking = skg
suction = sucz
sudden = sdn
suddenly = sdnl
suffer = sfr
suffered = sfrd
suffering = sfrg
suffers = sfrs
sufficient = sfcnt
sufficiently = sfcntl
suffocate = sfoct
suffocated = sfoctd
suffocating = sfoctg
sugar = sgr
suggest = sgst
suggested = sgstd
suggesting = sgstg
suggestion = sgstz
suggestions = sgstzs
suggests = sgsts
suit = sut
suitable = sutb
suited = sutd
suits = suts
sum = sum
summarize = smrz
summarized = smrzd
summary = sumr
summer = smr
summit = sumt
summits = sumts
summon = smn
sun = sunn
Sunday = sun
sunny = sune
sunshine = sunsin
super = supr
superb = sprb
superficial = sprfcl
superfluous = sprflus
superhuman = sprhumn
superior = suprr
supervise = sprviz
supervised = sprvizd
supervises = sprvizs
supervising = sprvizg
supervision = sprvz
supervisor = sprvizr
supper = spr
supple = supl
supplied = splid
supplies = splis
supply = spli
supplying = splig
support = sport
supportable = sportb
supported = sportd
supporting = sportg
supportive = sportv
supports = sports
suppose = spos
supposed = sposd
suppress = sprs
suppressed = sprsd
suppression = sprsz
supreme = sprem
sure = sur
surely = surl
surface = srfc
surfaces = srfcs
surfing = surfg
surge = srj
surgery = srjr
surges = srjs
surging = srjg
surmount = srmnt
surpass = srps
surpassed = srpsd
surpasses = srpss
surpassing = srpsg
surplus = srpls
surprise = sprz
surprised = sprzd
surprises = sprzs
surprising = sprzg
surprisingly = sprzgl
surrender = srndr
surround = srnd
surrounded = srndd
surrounding = srndg
surroundings = srndgs
surrounds = srnds
surveillance = srvlnc
survey = srva
surveys = srvas
survival = srvvl
survive = srvv
survived = srvvd
survives = srvvs
surviving = srvvg
survivor = srvvr
suspect = sspct
suspected = sspctd
suspend = sspnd
suspended = sspndd
suspense = sspns
suspicion = sspz
suspicions = sspszs
suspicious = sspsus
sustain = sstan
sustainable = sstanb
sustained = sstand
sustaining = sstang
sustains = sstans
sustenance = sstnnc
swallow = swlo
swallowed = swlod
swallows = swlos
swap = swp
swapped = swpd
swapping = swpg
swaps = swps
swarm = swrm
swarming = swrmg
swarms = swrms
sway = swa
sways = swas
swear = swr
swears = swrs
sweep = swep
sweeping = swepg
sweeps = sweps
sweet = swet
sweeter = swetr
sweetest = swetst
sweetly = swetl
sweetness = swetns
sweets = swets
swell = swl
swelling = swlg
swept = swpt
swift = swft
swiftly = swftl
swim = swm
swimming = swmg
swing = swg
swinging = swgg
swings = swgs
swipe = swip
swiped = swipd
swipes = swips
swiping = swipg
swirl = swrl
swirled = swrld
swirling = swrlg
swirls = swrls
switch = swc
switched = swcd
switches = swcs
switching = swcg
swoop = swop
swooped = swopd
swooping = swopg
swoops = swops
sword = swrd
swords = swrds
swung = swng
symbol = smbl
symbolic = smblc
symbols = smbls
sympathy = smpt
symptom = smtom
symptoms = smtoms
syndrome = sndrm
syndromes = sndrms
synergy = snrg
synthesis = sntss
system = sstm
systematic = sstmtc
systems = sstms
table = tbl
tables = tbls
tablet = tblt
tablets = tblts
tackle = tkl
tackled = tkld
tackles = tkls
tackling = tklg
tactic = tctc
tactical = tctcl
tactics = tctcs
tactile = tctil
tail = tal
tailor = talr
tailors = talrs
tails = tals
take = tak
taken = takn
takes = taks
taking = takg
tale = tale
talent = tlnt
talented = tlntd
talents = tlnts
tales = tales
talk = tlk
talked = tlkd
talking = tlkg
talks = tlks
tall = tall
tame = tam
tamed = tamd
tames = tams
taming = tamg
tangent = tnjnt
tangents = tnjnts
tangible = tnjb
tangle = tngl
tangled = tngld
tangles = tngls
tangling = tnglg
tap = tp
tape = tap
taping = tapg
tapped = tpd
tapping = tpg
taps = tps
tar = tar
target = trgt
targeted = trgtd
targeting = trgtg
targets = trgts
task = tsk
tasking = tskg
tasks = tsks
taste = tast
tasted = tastd
tastes = tasts
tasting = tastg
taught = twt
tax = tx
taxed = txd
taxes = txs
tea = tea
teach = tec
teacher = tecr
teachers = tecrs
teaches = tecs
teaching = tecg
team = tem
teaming = temg
teams = tems
tear = tear
tearing = terg
tears = tears
technical = tcncl
technically = tcncll
technique = tcnc
techniques = tcncs
technologies = tcnlgs
technology = tcnlg
tedious = tdus
tedium = tdum
teenager = tenjr
teenagers = tenjrs
teeth = tet
telegram = tlgm
telephone = tlfon
telephoned = tlfond
telephones = tlfons
television = tvz
tell = tl
telling = tlg
tells = tls
temper = tmpr
temperament = tmprm
temperature = tmptur
temperatures = tmps
tempered = tmprd
tempo = tmpo
temporarily = tmprrl
temporary = tmprr
tempt = tmpt
temptation = tmptz
tempted = tmptd
tempting = tmptg
tempts = tmpts
ten = ten
tenacious = tnasus
tenacity = tnct
tend = tnd
tended = tndd
tendencies = tndncs
tendency = tndnc
tender = tndr
tendon = tndn
tendons = tndns
tends = tnds
tense = tns
tensed = tnsd
tensing = tnsg
tension = tnz
tensions = tnzs
tent = tnt
tentative = tnttv
tents = tnts
tenuous = tnus
tenure = tnur
term = trm
terminal = trmnl
terminate = trmint
terms = trms
terrain = teran
terrible = trbl
terribly = trbll
terrific = trfic
terrified = trfid
terrifying = trfig
territories = trtrs
territory = trtr
terror = tror
test = tst
testament = tstm
tested = tstd
testify = tstfi
testimonial = tstmnl
testimony = tstmn
testing = tstg
tests = tsts
tether = tetr
tethered = ttrd
tethers = tetrs
text = txt
texts = txts
texture = txtr
textures = txtrs
than = tan
thank = tank
thankful = tankf
thankfulness = tankfns
thanking = tankg
thanks = tanks
thanksgiving = tanksgvg
that = tt
that's = tts
the = e
theater = teatr
their = ter
theirs = ters
them = tm
theme = teme
themes = temes
themselves = tmsvs
then = tn
theories = teors
theory = teor
therapeutic = teraputc
therapy = terp
there = tr
there's = trs
thereby = trbi
therefore = tf
thermal = trml
thermometer = trmmtr
these = tes
they = ta
thick = tik
thin = tin
thing = tg
things = tgs
think = tnk
thinker = tnkr
thinkers = tnkrs
thinking = tnkg
thinks = tnks
third = trd
thirst = tirst
thirsty = tirte
thirty = trte
this = ts
thorough = toro
thoroughly = torol
those = tos
though = tou
thought = tot
thoughtful = totf
thoughtfulness = totfulns
thoughts = tots
thousand = tsnd
thousands = tsnds
thrash = tras
thread = tred
threads = trds
threat = trt
threaten = trtn
threatened = trtnd
threatening = trtng
threats = trts
three = tre
threw = trw
thrift = trft
thrill = trl
thrilling = trlg
thrive = triv
thrives = trivs
throat = trot
through = trou
throughout = trouot
throw = tro
throwing = trog
thrown = tron
throws = tros
thrust = trust
thrusting = trustg
thumb = tmb
thunder = tundr
Thursday = thu
thus = thus
thwart = twrt
thwarted = twrted
tick = tic
ticket = tkt
tickets = tkts
ticking = tikg
ticks = tics
tide = tide
tides = tides
tie = ti
tied = tid
ties = tis
tight = tit
tighten = titn
tightening = titng
tighter = titr
tightly = titl
tightness = titns
tile = til
time = tim
timeless = timls
timely = timl
times = tims
timing = timg
tin = tinn
tiny = tine
tip = tip
tips = tips
tire = tir
tired = tird
tireless = tirls
tires = tirs
tiresome = tirsm
tiring = tirg
tissue = tsu
title = title
titles = titls
to = t
toast = tost
today = tda
toe = toe
toes = toes
together = tgr
toil = tyl
token = tokn
told = tld
tolerable = tlrb
tolerance = tlrnc
tolerant = tlrnt
tolerate = tlrt
tolerated = tlrtd
tolerating = tlrtg
tomorrow = tmro
ton = ton
tone = tone
tones = tones
tongue = tong
tonight = tnit
tons = tons
too = to
took = tk
tool = tol
tools = tols
tooth = toot
top = top
topic = topc
topical = topcl
topics = topcs
tops = tops
tore = tor
torment = trmnt
torments = torms
torn = torn
tornado = trndo
torrent = tornt
torture = trtur
tortures = trturs
torturing = trturg
tossed = tosd
total = ttl
totally = ttll
touch = tuc
touched = tucd
touches = tucs
touching = tucg
tough = tuf
tougher = tufr
toughest = tufst
toughness = tufns
tour = tur
touring = turg
tourist = turst
tours = turs
tow = tow
toward = twd
tower = towr
town = twn
towns = twns
toxic = txc
toy = ty
toys = toys
trace = trac
track = trk
tracked = trkd
tracking = trkg
tracks = trks
traction = trcz
trade = trad
traded = tradd
trading = tradg
tradition = trdz
traditional = trdzl
traditions = trdzs
traffic = trfc
tragedy = trjd
tragic = trjc
trail = tral
trailing = tralg
trails = trals
train = tran
trained = trand
training = trang
trains = trans
trait = trat
traits = trats
trance = trnc
tranquil = trncl
tranquility = trnclt
transcend = trsnd
transcended = trsndd
transcendent = trsndnt
transcribe = trscrib
transcribed = trscribd
transcribing = trscribg
transcription = trscrpz
transfer = trsfr
transferred = trsfrd
transferring = trsfrg
transform = trsfrm
transformation = trsfrmz
transformed = trsfrmd
transforming = trsfrmg
transforms = trsfrms
transgress = trsgrs
transgressions = trsgrzs
transient = trsnt
transition = trsz
transitions = trszs
translate = trslt
translated = trsltd
translating = trsltg
translation = trslz
transmission = trsmz
transmit = trsmt
transmitted = trsmtd
transmitting = trsmtg
transparent = trsprnt
transparently = trsprntl
transplant = trsplnt
transport = trsport
transportation = trsportz
transported = trsportd
transports = trsports
trap = trap
trapped = trapd
trauma = truma
traumatic = trmtc
travel = trvl
traveled = trvld
traveler = trvlr
travelers = trvlrs
traveling = trvlg
travels = trvls
treacherous = trcrus
treasure = trsr
treasured = trsrd
treasures = trsrs
treasury = trsrr
treat = tret
treated = tretd
treating = tretg
treatment = tretm
tree = tree
trees = tres
tremendous = trmnds
tremendously = trmndsl
trepidation = trpdz
trial = tril
trials = trils
triangle = trgl
triangles = trigls
tribe = trib
tribes = tribs
tribulations = trblzs
tribute = trbut
trick = trik
tricked = trikd
trickle = trkl
trickling = trklg
tricks = triks
tricky = trike
tried = trid
tries = tris
trigger = trgr
triggered = trgrd
triggers = trgrs
trillion = triln
trim = trim
trip = trp
triple = trpl
tripped = trpd
tripping = trpg
trips = trps
trite = trit
triumph = trimf
trivia = triva
trivial = trvil
troop = trop
troops = trops
tropical = trpcl
trouble = trubl
troubled = trubld
troubles = trubls
troublesome = trublsm
troubling = trublg
truck = truk
trucks = truks
true = tru
truly = trul
trunk = trnk
trust = trst
trusted = trstd
trusting = trstg
trustworthy = trstwrt
truth = trut
truthful = trutf
try = tri
trying = trig
tube = tub
tubes = tubs
Tuesday = tue
tumble = tmbl
tumbling = tmblg
tune = tun
tuned = tund
tuning = tung
tunnel = tnl
turmoil = trmyl
turn = trn
turned = trnd
turning = trng
turns = trns
tutor = tutr
twelve = twlv
twenty = twnt
twice = twc
twist = twst
twisted = twstd
twisting = twstg
twists = twsts
two = two
tying = tig
type = typ
typed = typd
types = typs
typewriter = typrtr
typical = tpcl
typically = tpcll
typing = typg
tyranny = trny
tyrant = tirnt
ugliness = uglns
ugly = ugl
ultimate = ultmt
ultimately = ultmtl
unable = uab
unanswered = uansrd
unappreciated = uaprctd
unattainable = uatanb
unattractive = uatrctv
unavoidable = uvydb
unaware = uawr
unbeatable = ubetb
unbelievable = ublvb
unbiased = ubisd
unbound = ubnd
unbounded = ubndd
uncanny = ucn
uncertain = ucrtn
uncertainties = ucrtnts
uncertainty = ucrtnt
unchanged = ucnjd
uncle = ucl
unclear = uclr
uncles = ucls
uncluttered = ucltrd
uncomfortable = ucfrtb
uncommon = ucmn
unconscious = ucsus
unconsciously = ucsusl
uncover = ucv
uncovered = ucvd
uncovering = ucvg
undecided = udcidd
undeniable = udnib
undependable = udpndb
under = und
undercurrent = ucurnt
undercut = udct
underestimate = uestmt
underestimated = uestmtd
underestimating = uestmtg
undergo = ug
undergoing = ugg
underground = ugrnd
underlie = uli
underline = ulin
underlying = ulig
underneath = unet
underscore = uscor
understand = ustnd
understandable = ustndb
understanding = ustndg
understands = ustnds
understatement = ustatm
understood = ustod
undertake = utak
undertaken = utakn
undertaking = utakg
undertook = utk
underway = uwa
undeveloped = udvlpd
undisciplined = udsplnd
undivided = udvidd
unease = ues
unemotional = uemozl
unemotionally = uemozll
unending = uendg
uneventful = uevntf
unexamined = uxmnd
unexpected = uxpctd
unfair = ufar
unfamiliar = ufmlr
unfeeling = ufelg
unfinished = ufnsd
unfold = ufld
unfolding = ufldg
unfolds = uflds
unforeseen = ufsen
unforgettable = ufgtb
unfortunate = ufrtunt
unfortunately = uftntl
ungrateful = ugratf
unhappiness = uhapns
unhappy = uhap
unheard = uhrd
unified = ufid
uniform = unfrm
unify = ufi
unimaginable = umjnb
uninteresting = untrstg
uninterrupted = untrptd
union = unon
unions = unons
unique = unic
unison = unson
unit = unt
unite = unit
united = unitd
units = unts
unity = unte
universal = uvrsl
universe = uvrs
universities = uvrsts
university = uvrst
unjust = uj
unknown = ukn
unlearn = ulrn
unleash = ules
unleashed = ulesd
unleashing = ulesg
unless = uls
unlike = ulik
unlikely = ulikl
unlimited = ulmtd
unlock = ulok
unlocked = ulokd
unlocking = ulokg
unlocks = uloks
unmistakable = umstkb
unnatural = untrl
unnecessarily = uncsrl
unnecessary = uncsr
unnoticed = unotcd
unobtrusive = uobtrsv
unpack = upk
unpacked = upkd
unpacking = upkg
unpacks = upks
unparalleled = uprlld
unpleasant = uplsnt
unpredictable = updctb
unprepared = uppard
unproductive = updctv
unravel = urvl
unrealistic = urelstc
unrelated = urlatd
unrelenting = urlntg
unreliable = urlib
unresolved = ursolvd
unresponsive = urspnsv
unseen = usen
unsettled = usetld
unsettling = usetlg
unshakable = usakb
unskilled = uskld
unsolved = usolvd
unspeakable = uspekb
unstable = ustb
unstructured = ustrctrd
unsure = usur
untamed = utamd
untangle = utngl
untangled = utngld
unthinkable = utnkb
until = utl
unused = uuzd
unusual = uusl
unwanted = uwntd
unwelcome = uwlcm
unwilling = ulg
unwind = uwnd
unwinds = uwnds
unwise = uwz
up = p
upbeat = pbet
upcoming = pcmg
update = pdat
updates = pdats
updating = pdatg
upgrade = pgrad
uphill = phl
upholds = phlds
upkeep = pkp
uplifting = plftg
upon = upn
upper = upr
upright = prit
upset = upst
upsetting = upstg
upstanding = pstndg
uptake = ptak
uptight = ptit
upward = pwd
urge = urj
urgency = urjnc
urgent = urjnt
us = us
usable = uzb
use = uz
used = uzd
useful = uzf
usefulness = uzfns
useless = uzls
uses = uzs
using = uzg
usual = usl
usually = usll
utility = utlt
utilize = utlz
utmost = utmo
utter = utr
utterly = utrl
vacation = vcz
vacillating = vcltg
vacuum = vcum
vague = vag
vain = van
valiantly = vlntl
valid = vld
validation = vldz
validity = vldt
valley = vl
valleys = vls
valuable = vlub
value = vlu
values = vlus
valve = vlv
vanity = vant
vantage = vntj
variable = vrib
variation = varz
variations = varzs
varied = vard
varies = vars
varieties = varits
variety = varit
various = varus
vary = var
varying = varg
vast = vast
vegetable = vgtb
vegetables = vgtbls
vehicle = vhcl
vehicles = vhcls
vengeance = vnjnc
venture = vntr
ventures = vnturs
verbal = vrbl
verbalize = vrblz
verbalized = vblzd
verbally = vrbll
verge = vrj
verified = vrfid
verifies = vrfis
verify = vrfi
verifying = vrfig
versatile = vrstl
version = vrz
versions = vrzs
vertical = vrtcl
verve = vrv
very = vr
vessel = vesl
vessels = vesls
vestige = vstj
vestment = vstm
viable = vib
vibrancy = vibrnc
vibrant = vibrnt
vibrantly = vbrntl
vibrate = vibrt
vibrating = vibrtg
vibration = vibrz
vice = vic
vices = vics
vicious = vsus
victim = vctm
victims = vctms
victories = vctrs
victory = vctr
video = vdeo
videos = vdeos
view = vw
viewed = vwd
viewing = vwg
viewpoint = vwpnt
views = vws
vigil = vjl
vigilance = vjlnc
vigilant = vjlnt
vigils = vjls
vigor = vgr
vigorous = vgrus
vigorously = vgrsl
village = vlj
villages = vljs
villain = viln
villains = vilns
vindicate = vndct
vindicated = vndctd
vindicates = vndcts
vindicating = vndctg
vindication = vndcz
violate = vilt
violated = viltd
violates = vilts
violating = viltg
violation = vilz
violence = vilnc
violent = vilnt
violin = voln
violins = volns
virtually = vrtl
virtue = vrtu
virtues = vrtus
virtuous = vrtuos
visibility = vsbt
visible = vsb
vision = vz
visions = vzs
visit = vst
visited = vstd
visiting = vstg
visitor = vstr
visitors = vstrs
visits = vsts
visual = vsl
visualization = vslzz
visualize = vslz
visualizing = vslzg
visually = vsll
vital = vitl
vitality = vitlt
vivacity = vvct
vivid = vvd
vividly = vvdl
vocabulary = vcblr
vocation = vocz
vogue = vog
voice = vyc
voiced = vycd
voices = vycs
voicing = vycg
void = vyd
volcano = vlcno
volcanoes = vlcnos
volts = vlts
volume = vlm
volumes = vlms
voluntary = vlntr
volunteer = vlnter
volunteers = vlnters
voluptuous = vlptus
vote = vot
vowed = vowd
vowel = vowl
voyage = voj
vulnerability = vlnrbt
vulnerable = vlnrb
wade = wad
waded = wadd
wades = wads
wading = wadg
wage = wj
waged = wjd
wages = wjs
waging = wjg
wagon = wagn
wagons = wgns
wail = wal
wailed = wald
wailing = walg
wait = wat
waited = watd
waiting = watg
waits = wats
wake = wak
wakes = waks
waking = wakg
walk = wlk
walked = wlkd
walking = wlkg
walks = wlks
wall = wll
walls = wlls
wander = wandr
wandering = wandrg
wanders = wandrs
want = wnt
wanted = wntd
wanting = wntg
wants = wnts
war = war
ward = ward
warehouse = warhus
warm = wrm
warmed = wrmd
warmer = wrmr
warmest = wrmst
warming = wrmg
warms = wrms
warmth = wrmt
warn = wrn
warned = wrnd
warning = wrng
warnings = wrngs
warns = wrns
warranty = warnt
wart = wart
warts = warts
was = z
wash = wash
washed = wasd
washer = wasr
washes = wass
washing = wasg
Washington = wston
wasn't = znt
waste = wast
wasted = wastd
wasteful = wastf
wastes = wasts
wasting = wastg
watch = wtc
watched = wtcd
watches = wtcs
watchful = wtcf
watching = wtcg
water = wtr
waters = wtrs
wave = wav
waved = wavd
waves = wavs
waving = wavg
wax = wx
way = wa
ways = was
wayside = wasid
we = we
we'll = well
weak = wek
weaker = wekr
weakness = wekns
wealth = wlt
wean = wen
weaning = weng
weapon = wpn
weapons = wpns
wear = wear
wearing = wearg
wears = wears
weary = were
weather = weatr
weathered = weatrd
weave = wev
weaves = wevs
weaving = wevg
web = wb
webs = wbs
wedding = wdg
weddings = wdgs
wedge = wdj
Wednesday = wed
weed = weed
weeds = weeds
week = wk
weekend = wknd
weekly = wkl
weeks = wks
weep = wep
weeping = wepg
weeps = weps
weigh = weg
weighed = wegd
weighing = wegg
weighs = wegs
weight = wet
weights = wets
weird = werd
welcome = wlcm
welcoming = wlcmg
welfare = wlfar
well = wl
wellbeing = wlbg
went = went
wept = wpt
were = wer
weren't = wernt
west = wst
western = wstrn
wet = wtt
what = wt
what's = wts
whatever = wtev
whatsoever = wtsoev
wheat = weat
wheel = wel
wheels = wels
when = wn
whenever = wnev
where = wr
wherever = wrev
whether = wetr
which = wc
while = wil
whimper = wmpr
whimpering = wmprg
whimpers = wmprs
whip = wp
whisper = wspr
whispered = wsprd
whispering = wsprg
whispers = wsprs
whistle = wsl
whistled = wsld
whistles = wsls
whistling = wslg
white = wit
who = wo
whoever = woev
whole = wol
whom = wom
whose = wos
why = y
wide = wid
widely = widl
widen = widn
wider = widr
widest = widst
width = wdt
wife = wif
wiggle = wgl
wild = wld
wilderness = wldrns
wildest = wldst
will = l
willing = lg
willingly = lgl
willingness = lgns
win = wnn
wince = wnc
wind = wnd
winding = wndg
window = wndo
windows = wndos
winds = wnds
wine = wine
wing = wg
wings = wgs
wink = wnk
winner = wnnr
winning = wnng
wins = wns
winter = wntr
wipe = wip
wiped = wipd
wipes = wips
wiping = wipg
wire = wir
wired = wird
wires = wirs
wiring = wirg
wisdom = wzdm
wise = wz
wisely = wzl
wiser = wzr
wisest = wzst
wish = ws
wished = wsd
wishes = wss
wishful = wsf
wishing = wsg
wisp = wsp
wistful = wstf
wit = witt
with = w
withdraw = wdrw
wither = witr
withhold = whld
within = win
without = wot
withstand = wstnd
witness = wtns
witnessed = wtnsd
witnessing = wtnsg
wits = wits
wives = wivs
wizard = wzrd
woe = woe
woes = woes
woke = wok
woman = wmn
women = wmen
won = won
won't = wont
wonder = wndr
wondered = wndrd
wonderful = wndrf
wondering = wndrg
wonders = wndrs
wood = wod
wooden = wdn
woods = wods
wool = wool
word = wrd
words = wrds
wore = wor
work = wrk
workable = wrkb
worked = wrkd
worker = wrkr
workers = wrkrs
working = wrkg
workings = wrkgs
workload = wrklod
workman = wrkmn
workmanship = wrkmnzp
works = wrks
world = wrld
world's = wrldss
worlds = wrlds
worm = worm
worms = worms
worn = worn
worried = wored
worries = wores
worrisome = woresm
worry = wore
worrying = woreg
worse = wrs
worsens = wrsns
worst = wrst
worth = wrt
worthless = wrtls
worthwhile = wrtwil
worthy = wrte
would = wd
wouldn't = wdnt
wound = wond
wounds = wunds
wove = wov
wow = ww
wracked = rkd
wracking = rkg
wrap = rp
wrapped = rpd
wraps = rps
wreck = rek
wrenching = rncg
wrestling = rstl
wringer = rgr
wrinkle = rnkl
wrinkles = rnkls
wrist = rist
wrists = rists
write = rit
writer = ritr
writers = ritrs
writes = rits
writing = ritg
writings = ritgs
written = rtn
wrong = rong
wrongs = rongs
wrote = rote
yacht = yat
yachts = yats
yard = yd
yards = yds
year = yer
year's = yerss
yearn = yrn
yearns = yrns
years = yers
yellow = ylo
yes = ys
yesterday = ysda
yet = yt
yield = yeld
you = u
you're = ur
young = yng
younger = yngr
your = yr
yours = yrs
yourself = ysf
yourselves = yrsvs
youth = yut
youthful = yutf
zeal = zel
zero = zro
zest = zst
zone = zn
zoom = zm
