the	t
and	a
you	y
have	h	had	having
that	th
for	f
with	w
this	ti
not	n
but	b
they	te
say	s	said	saying
what	wh
from	fr
get	g	got	getting
can	c
know	k	known	knowing
your	yo
about	ab
their	tr
will	wi
would	wo
make	m	made	making
just	j
think	tn	thought	thinking
time	tm	timed	timing
out	o
come	co	come	coming
people	p
take	ta	taken	taking
year	ye
some	so
want	wa	wanted	wanting
when	we
which	wc
like	l	liked	liking
other	ot
could	cu
into	i
here	he
look	lo	looked	looking
more	mo
these	ts
thing	tg
well	wl
because	be
also	al
use	u	used	using
tell	tl	told	telling
good	go
first	fi
day	d
find	fd	found	finding
give	gi	given	giving
those	to
very	v
need	ne	needed	needing
back	ba	backed	backing
should	sh
even	e
only	on
many	ma
really	r
work	wr	worked	working
life	li
right	ri
down	do
something	sm
call	ca	called	calling
woman	wm
still	st
through	tu
mean	me	meant	meaning
after	af
never	nv
world	wd
feel	fe	felt	feeling
yeah	ya
great	gr
last	la	lasted	lasting
child	ch
over	ov
school	sc
state	sa	stated	stating
much	mu
talk	tk	talked	talking
keep	ke	kept	keeping
leave	le	left	leaving
help	hl	helped	helping
same	se
start	sr	started	starting
high	hi
every	ev
another	an
become	bc	become	becoming
most	ms
between	bw
happen	ha	happened	happening
family	fa
president	pr
house	ho
show	sw	showed	showing
again	ag
student	su
might	mi
part	pa	parted	parting
hear	hr	heard	hearing
place	pl	placed	placing
problem	po
believe	bl	believed	believing
country	cn
always	aw
week	wk
point	pi	pointed	pointing
hand	hd	handed	handing
play	py	played	playing
group	gu
against	ai
case	cs
question	q	questioned	questioning
night	ni
live	lv	lived	living
game	ga
number	nu	numbered	numbering
write	wt	written	writing
bring	br	brought	bringing
without	wu
money	my
book	bo	booked	booking
system	ste
government	gv
next	nt
city	ci
company	cm
story	sy
today	ty
move	mv	moved	moving
must	mt
friend	fri
during	du
begin	bi	begun	beginning
each	ea
different	di
american	am
little	lt
before	bf
ever	er
fact	fc
read	re	read	reading
anything	ay
nothing	no
small	sl
month	mn
program	pm	programmed	programming
maybe	mb
under	un
business	bu
home	hm
kind	ki
stop	sp	stopped	stopping
study	sd
since	si
issue	is
name	na	named	naming
idea	id
room	ro
percent	pe
away	aa
actually	ac
large	lg
though	tho
provide	pv	provided	providing
lose	ls	lost	losing
power	pw
understand	ud	understood	understanding
mother	mr
real	ra
best	bs
long	ln	longed	longing
young	yu
okay	ok
both	bh
service	ser
area	ar
important	im
person	ps
someone	sn
change	cg	changed	changing
however	hw
around	ao
hour	hu
everything	ey
national	nl
four	fo
girl	gl
until	ut
father	ft
create	cr
information	in
learn	lr	learnt	learning
already	ae
kill	kl	killed	killing
minute	min
party	pt
include	ic	included	including
together	tog
follow	fl	followed	following
health	ht
remember	rm	remembered	remembering
often	of
reason	rs
speak	sk	spoken	speaking
black	bk
member	mem
community	ct
once	oc
social	soc
news	nw
body	by
lead	ld	led	leading
continue	ce	continued	continuing
whether	whe
enough	en
level	ll	leveled	leveling
political	pc
almost	as
university	uv
five	fv
probably	pro
center	cen
public	pu
else	el
history	hs
result	ru
morning	mg
parent	pn
office	oi
course	cou
research	rc
door	dr
several	sev
grow	gw	grown	growing
better	bet
open	op	opened	opening
moment	mom
including	il
consider	cd	considered	considering
within	wn
second	sec
street	str
everyone	eve
policy	pol
table	tb
human	hn
please	ple	pleased	pleasing
hope	hp	hoped	hoping
process	prc
teacher	tc
data	da
offer	or	offered	offering
death	de
experience	ex
easy	es
education	ed
build	bd	built	building
expect	ep	expected	expecting
himself	him
sense	ss	sensed	sensing
across	acr
college	cl
music	mc
appear	ap	appeared	appearing
mind	md
police	poi
effect	ef
season	sea
possible	pos
serve	sv	served	serving
although	at
market	mk
require	reu
listen	lis	listened	listening
according	ad
anyone	any
baby	bb
wrong	wg
decide	dc	decided	deciding
republican	rp
full	fu
behind	bn
interest	it	interested	interesting
sometimes	som
security	seu
report	rt	reported	reporting
control	con
local	lc
suggest	sg	suggested	suggesting
nation	nat
action	act
support	sup	supported	supporting
wife	wf
decision	ds
receive	rv	received	receiving
value	va	valued	valuing
pick	pk	picked	picking
phone	ph	phoned	phoning
thanks	tha
event	et
drive	dv	driven	driving
strong	sto
reach	rh
remain	rn	remained	remaining
explain	ei	explained	explaining
church	chu
model	ml
perhaps	per
relationship	rel
fine	fn
player	pla
couple	cp
million	mil
themselves	tv
record	rd	recorded	recording
especially	ec
difference	df
light	lh	lighted	lighting
development	dl
federal	fed
former	for
role	rl
pretty	pre
myself	mye
view	vi
effort	efo
nice	nc
quite	qu
voice	vo	voiced	voicing
finally	fy
department	dm
either	eh
toward	tw
leader	lea
project	prt
return	ret	returned	returning
position	pot
special	spe
film	fm	filmed	filming
type	tp	typed	typing
article	art
chance	cha
drug	dg
economic	em
situation	sit
choose	cho	chosen	choosing
practice	pra	practiced	practicing
happy	hy
science	sci
join	jo	joined	joining
develop	dev	developed	developing
yourself	yr
carry	cy	carried	carrying
brother	bro
matter	mat	mattered	mattering
dead	dd
image	ia
simply	sim
society	soi
picture	pic
paper	pp
energy	eg
personal	pes
building	bul
military	mit
doctor	doc
activity	av
exactly	exa
evidence	evi
product	prd
realize	rz	realized	realizing
technology	tec
catch	cc	caught	catching
comment	com	commented	commenting
cover	cv	covered	covering
describe	des	described	describing
guess	ge	guessed	guessing
choice	chi
source	sou
director	dir
international	ie
campaign	cam
ground	gn
election	ele
check	ck	checked	checking
page	pg
fight	fg	fought	fighting
itself	if
test	tt	tested	testing
patient	pat
produce	pru	produced	producing
certain	cer
whatever	wv
half	hf
video	vd
third	td
recent	rec
available	ava
ready	ry
opportunity	ou
official	oa
organization	og
character	chr
single	sin
current	cur
likely	lk
county	cot
future	fut
whose	ws
industry	ir
general	gen
stuff	sf	stuffed	stuffing
figure	fig
attention	ate
forget	fog	forgotten	forgetting
risk	rk	risked	risking
focus	fs
condition	cod
daughter	dh
author	au
upon	up
husband	hb
period	pei
series	sei
order	od	ordered	ordering
officer	ofi
computer	cop
thought	thu
economy	eco
behavior	bv
certainly	cet
nearly	nr
increase	inc	increased	increasing
north	nh
culture	cul
medical	med
everybody	eb
difficult	dif
language	lu
window	win
response	res
population	pop
worker	wor
draw	dw	drawn	drawing
drop	dp	dropped	dropping
private	pri
tonight	ton
letter	let
simple	sip
wonder	won	wondered	wondering
involve	iv
answer	ans	answered	answering
nature	nau
administration	adm
common	cmo
message	mes
enjoy	eo	enjoyed	enjoying
similar	sil
congress	cog
attack	ak	attacked	attacking
amount	amo
analysis	ana
defense	dn
performance	pf
hospital	hos
protect	poc	protected	protecting
century	ceu
summer	sum
material	mae
individual	ind
recently	ren
example	exp
represent	rep
animal	ani
factor	fac
natural	nar
agency	age
usually	us
significant	sig
ability	abi
statement	sta
entire	ent
democrat	dem
serious	ses
career	car
dollar	dol
vote	vt	voted	voting
compare	coa	compared	comparing
forward	fw
subject	sb
financial	fin
identify	iy	identified	identifying
beautiful	bea
decade	dec
reduce	red	reduced	reducing
sister	sis
quality	qa
quickly	qi
worry	wy	worried	worrying
accept	ace	accepted	accepting
enter	ee	entered	entering
mention	men	mentioned	mentioning
movement	mov
section	set
treatment	tre
benefit	ben
interesting	ig
candidate	can
approach	ah
determine	det
resource	rer
size	sz
somebody	sob
knowledge	kn
rather	rat
hang	hg	hanged	hanging
left	lf
meeting	met
feeling	fel
despite	dep
degree	deg
imagine	ima	imagined	imagining
king	kg
present	prs	presented	presenting
foreign	foi
disease	dis
lady	ly
beyond	bey
discuss	dic
finish	fis
design	dei
concern	coc	concerned	concerning
recognize	rg	recognized	recognizing
prepare	prp	prepared	preparing
network	nk
success	suc
district	dit
physical	phy
growth	gh
standard	stn
theory	the
september	sep
outside	os
strategy	sty
clearly	cle
property	pry
authority	aut
perfect	pef
method	meh
region	reg
impact	ip
indicate	ini
committee	coi
supposed	suo
training	tra
central	cea
option	opi
particularly	par
completely	col
opinion	opn
interview	iw
remove	rem	removed	removing
dark	dk
union	uo
professor	prf
pressure	peu
purpose	pur
herself	her
artist	ari
employee	emp
account	aco
release	rea	released	releasing
environment	env
specific	spc
version	ve
reality	rei
visit	vs	visited	visiting
club	cb
justice	ju
river	rr
memory	mer
camera	cae
global	glo
various	vr
arrive	arv	arrived	arriving
notice	not	noticed	noticing
detail	dea
challenge	chl	challenged	challenging
argument	arg
nobody	nb
weapon	wp
station	sti
island	isl
absolutely	abs
instead	ins
discussion	dio
affect	afe
anyway	anw
respond	rsp
trouble	tro	troubled	troubling
conversation	cov
manage	man	managed	managing
date	dt
charge	chg	charged	charging
assume	asu
writer	wri
perform	pem	performed	performing
credit	cre
marriage	mar
operation	ope
indeed	ine
necessary	ns
reveal	rev	revealed	revealing
access	acs
debate	deb	debated	debating
contain	cnt	contained	containing
beat	bt	beaten	beating
democratic	der
glass	gs
improve	io	improved	improving
religious	rig
review	rw
address	adr
association	aso
measure	mea	measured	measuring
lawyer	lw
production	prn
relate	rae	related	relating
middle	mid
management	mag
original	ol
victim	vc
cancer	cac
speech	sph
particular	pai
none	nn
weight	wei
tomorrow	tom
positive	pov
citizen	cz
establish	est
executive	eu
politics	pli
customer	cus
manager	mge
publish	pub
popular	pou
conference	cf
discover	div
direction	die
sunday	sun
maintain	mai	maintained	maintaining
majority	mao
dinner	din
partner	pan
user	ue
therefore	tf
owner	ow
inside	isi
june	jn
mountain	mou
friday	frd
attorney	ato
unless	ul
expert	exe
structure	stu
budget	bud
insurance	inu
text	tx
freedom	fre
reader	rad
march	mh	marched	marching
machine	mac
november	nov
generation	ger
income	ino
onto	oo
throughout	thr
threat	tht
solution	sol
travel	trv	traveled	traveling
scientist	sce
obviously	ob
refer	rf
investigation	inv
senator	sen
unit	ui
photograph	pho
july	jy
television	tel
sexual	sx
prevent	prv	prevented	preventing
modern	mod
senate	sna
violence	vl
feature	fea
audience	aud
evening	evn
suffer	suf	suffered	suffering
spring	spr
safety	saf
weekend	wek
normal	nor
yard	yd
finger	fie
mission	mis
eventually	evt
participant	pac
judge	jd	judged	judging
pattern	pae
institution	int
faith	fh
professional	pof
reflect	ref	reflected	reflecting
folk	fk
surface	sur
client	cli
traditional	trd
council	cun
device	dvi
environmental	eni
responsibility	rb
internet	inr
october	oct
immediately	ime
investment	ive
effective	efe
previous	pev
content	cne
consumer	cos
element	elm
nuclear	nuc
spirit	spi
directly	dy
afraid	afr
define	def
handle	han	handled	handling
announce	ano	announced	announcing
journal	ja
heavy	hv
collection	clc
soldier	sod
governor	gov
shoulder	sho
cultural	cut
successful	sue
suddenly	sud
interested	ite
deliver	del	delivered	delivering
saturday	sat
editor	edi
anybody	anb
destroy	dey
critical	cri
agreement	agr
powerful	pow
researcher	reh
concept	cnc
willing	wil
promise	prm	promised	promising
easily	eas
restaurant	rst
league	leg
senior	sni
capital	cap
anymore	anr
potential	pon
quick	qk
magazine	maz
status	sts
attend	atn	attended	attending
replace	rpl	replaced	replacing
kitchen	kc
achieve	ach
screen	scr
generally	gy
mistake	mia
strike	sri
battle	bat	battled	battling
corner	cor
target	tar
driver	dri
beginning	beg
religion	rio
crisis	crs
museum	mus
engage	eng
communication	cmu
murder	mur	murdered	murdering
object	obe	objected	objecting
express	exr
encourage	enc	encouraged	encouraging
blog	bg
belief	bel
debt	db
labor	lb
understanding	ur
neighborhood	ng
contract	cnr
species	sps
additional	adi
sample	sam
involved	inl
mostly	mos
concerned	cnd
conduct	cnu
wonderful	wod
library	lib
prison	pis
attempt	atm	attempted	attempting
complete	cmp	completed	completing
gift	gf
refuse	rfu	refused	refusing
garden	gar	gardened	gardening
introduce	itr	introduced	introducing
christian	chs
definitely	den
vehicle	vh
examine	exi	examined	examining
application	apl
thousand	ths
coffee	cof
billion	bil
reform	rfo
ignore	ign	ignored	ignoring
welcome	wel	welcomed	welcoming
gold	gd
jump	jm	jumped	jumping
planet	pln
location	loc
amazing	az
principle	pin
promote	pom
search	seh	searched	searching
possibility	pob
otherwise	oh
remind	rmi	reminded	reminding
healthy	hea
advantage	adv
commercial	cme
context	cx
highly	hig
christmas	cht
strength	sth
monday	mon
survey	suv
writing	wrt
master	mas
resident	rsi
football	fb
failure	fai
reporter	rpo
commit	cmi
associate	asc
vision	vn
function	fun
average	ave
stupid	sid
chinese	che
connection	cni
hundred	hun
afternoon	aft
responsible	reb
secretary	sey
apparently	apa
southern	sot
totally	tot
western	wes
collect	clt	collected	collecting
conflict	cnl
learning	ler
contribute	cob
british	bri
following	fol
newspaper	np
foundation	fou
variety	var
perspective	pep
document	dou
presence	pen
lesson	les
limit	lm
appreciate	apr	appreciated	appreciating
observe	obs	observed	observing
currently	cue
crowd	cw	crowded	crowding
apartment	apm
survive	srv
guest	gt
protection	pec
intelligence	ing
yesterday	yt
somewhere	sow
border	bor
reading	rai
leadership	lp
attitude	ati
website	wb
seriously	sel
actual	acu
recall	rca	recalled	recalling
negative	neg
connect	cec	connected	connecting
distance	dia
regular	rgu
climate	clm
relation	rao
flight	fli
dangerous	dan
aspect	asp
grab	gb	grabed	grabing
favorite	fav
january	jan
independent	inp
volume	vu
online	onl
theater	tea
identity	ide
demand	ded	demanded	demanding
demonstrate	dmo
tuesday	tue
facility	fal
august	aug
institute	ist
living	liv
european	eur
quarter	qr
basically	bas
forest	fos
multiple	mp
background	bac
settle	stl	settled	settling
winter	wit
presidential	ped
operate	opr	operated	operating
division	dvo
slowly	slo
advice	adc
reaction	rac
injury	iny
ticket	tic
painting	pag
outcome	om
damage	dam	damaged	damaging
commission	cms
captain	cat
female	fem
minister	mie
neighbor	nei
mental	mel
software	sof
finding	fid
temperature	tem
quiet	qe
spread	spa
bright	brg
influence	ifl	influenced	influencing
kick	kk	kicked	kicking
annual	anu
procedure	pod
respect	rse
tradition	tri
threaten	trt	threatened	threatening
primary	pim
strange	sra
blame	bm
active	aci
depend	dnd	depended	depending
clothes	clo
affair	afa
contact	cna
category	cag
victory	vic
direct	dre	directed	directing
towards	tow
ensure	ens
expression	exs
session	sio
competition	cmt
possibly	poy
technique	teh
intend	itn	intended	intending
impossible	ib
academic	aca
somehow	soh
gather	gat	gathered	gathering
scientific	scn
african	afi
participate	pap
appropriate	apo
youth	yh
straight	srg
weather	wea
recommend	rco	recommended	recommending
medicine	mei
obvious	obv
thursday	thd
exchange	exc
explore	exl	explored	exploring
extend	ext	extended	extending
invite	ivi	invited	inviting
belong	blo	belonged	belonging
obtain	oba	obtained	obtaining
conclusion	cns
progress	prg
surprise	sus	surprised	surprising
assessment	ase
defend	dfe
pound	pd
correct	crc	corrected	correcting
married	mad
slightly	sli
village	vg
historical	hc
meaning	meg
supply	sul	supplied	supplying
ourselves	our
consequence	cse
unique	uni
regulation	rgl
bottom	bot
excuse	exu	excused	excusing
familiar	fam
classroom	cla
reference	rfe
emerge	eme
desire	dsi	desired	desiring
instruction	isr
emergency	emr
thinking	thi
french	frn
combine	cmb
december	dce
anywhere	ane
chicken	chc
construction	cno
wednesday	wed
deserve	dse	deserved	deserving
famous	fao
intervention	itv
confirm	cfi	confirmed	confirming
insist	ii	insisted	insisting
fourth	fot
native	nai
supreme	spm
baseball	bae
accident	acd
growing	gro
struggle	sru
revenue	rve
expand	exd	expanded	expanding
launch	lau
repeat	rpe	repeated	repeating
breath	bre
inch	ih
terrible	ter
relatively	rey
complex	cox
generate	gea
extremely	exy
forever	fov
corporate	crp
prefer	pfe	preferred	preferring
except	ece
literature	lit
importance	imp
danger	dag
emotional	emo
capture	cau
traffic	trf
fucking	fuc
equipment	equ
select	sle
studio	sdi
expensive	exv
secret	sct
engine	ene
circle	cir
critic	crt
episode	epi
requirement	rqu
politician	poa
colleague	clg
disappear	dip
predict	pet	predicted	predicting
exercise	erc	exercised	exercising
democracy	dmc
ultimately	um
setting	seg
unfortunately	uf
united	unt
educational	edu
comfortable	cmr
investigate	ina
useful	use
pocket	pok
digital	dig
plenty	plt
entirely	enr
afford	afo	afforded	affording
teaching	tei
conservative	cnv
chairman	cai
bridge	brd
specifically	spf
flower	flo	flowered	flowering
universe	unv
acknowledge	ack	acknowledged	acknowledging
coverage	cve
locate	loa
balance	bal	balanced	balancing
zone	z
wedding	wen
joke	jk	joked	joking
minority	mio
russian	rus
soviet	sov
profit	pfi
careful	caf
gender	ged
ocean	oe
unidentified	und
circumstance	cic
declare	dcl	declared	declaring
domestic	dom
organize	oz
english	enl
neither	net
surround	sro	surrounded	surrounding
manner	mnn
surprised	srp
percentage	pea
massive	mav
winner	wie
honest	hon
propose	pse	proposed	proposing
sentence	snt
request	rqe	requested	requesting
appearance	ape
regarding	rga
excellent	ecl
criminal	crm
beauty	beu
bottle	bol
component	cpo
jewish	je
yours	ys
plastic	pls
indian	idi
stress	sre	stressed	stressing
illegal	ile
significantly	sif
february	feb
constitution	cst
definition	dfi
uncle	uc
suppose	spo	supposed	supposing
investor	ivt
eastern	eat
valley	val
largely	lar
abortion	abo
chapter	chp
commitment	cit
celebrate	cel
arrest	are	arrested	arresting
urban	ub
internal	ita
bother	boh
proposal	psa
capacity	cay
guilty	gul
catholic	cah
variable	vb
convention	cvn
jury	jr
incident	ici
hearing	hei
everywhere	ew
payment	pay
conclude	clu	concluded	concluding
scream	sca	screamed	screaming
surgery	sug
shadow	sha
witness	wis
increasingly	icr
amendment	ame
complain	cml	complained	complaining
extent	ete
pleasure	plu
holiday	hol
talent	tal
necessarily	ny
liberal	lie
expectation	exo
accuse	aus
knock	ko	knocked	knocking
previously	pel
corporation	cro
sector	sco
experiment	epe
farmer	far
confidence	cfd
northern	noh
speaker	sek
breast	bra
contribution	cnb
creative	cra
interaction	itc
pursue	pus
overall	ove
package	pak
difficulty	dil
hardly	har
estimate	esi
invest	ies	invested	investing
personally	pey
notion	noi
explanation	epl
airport	air
expose	epo
convince	cvi
channel	cal
carefully	crf
estate	esa
initial	iti
purchase	puc
birthday	bir
improvement	imr
ancient	anc
escape	esc	escaped	escaping
fashion	fas
length	len
funding	fud
meanwhile	mw
barely	bar
eliminate	eli
motion	mot
essential	ese
combination	cma
limited	lim
description	dsc
implement	iml
proper	por
marketing	mak
approve	apv	approved	approving
regional	rgi
muscle	muc
creation	crn
typically	typ
spending	spn
instrument	isu
kiss	ks	kissed	kissing
increased	ice
inspire	isp	inspired	inspiring
separate	sar	separated	separating
yellow	yl
signal	sia	signaled	signaling
golden	gol
reject	rct	rejected	rejecting
inform	ifo	informed	informing
perception	pce
visitor	vis
contrast	ctr
judgment	jg
representative	rpr
regime	rgm
merely	mey
producer	pue
typical	tyi
analyst	anl
disability	dib
comparison	cpa
rating	ran
campus	cas
assess	aes
branch	brn	branched	branching
somewhat	soa
gentleman	gm
opposition	opo
suspect	sut	suspected	suspecting
athlete	ath
opening	oni
prayer	pye
frequently	fru
employ	eml	emploied	employing
basketball	bak
existing	exg
revolution	rvo
emotion	emt
platform	plf
appeal	aea	appealed	appealing
quote	qo	quoted	quoting
enable	ena
legislation	lei
addition	ado
oppose	ops
immigration	imi
observation	obr
decline	dci
attract	atr	attracted	attracting
household	hou
breathe	brt	breathed	breathing
existence	eis
mirror	mir
relief	rie
warning	war
heaven	hev
literally	lir
quit	qt	quitted	quitting
calorie	cao
german	gem
employer	emy
technical	ten
disaster	dsa
display	diy
bathroom	bah
succeed	scd	succeeded	succeeding
consistent	csi
agenda	agn
enforcement	eno
silence	sie
journalist	ji
queen	qn
divide	did	divided	dividing
expense	epn
exposure	eps
priority	pio
journey	jou
relevant	rva
cheese	ces
schedule	sch
bedroom	bed
selection	slc
perfectly	pfc
veteran	vet
disagree	dsg
characteristic	cte
protein	prot
resolution	rso
regard	rgr
engineer	egi
depression	drs
visual	via
initiative	iat
whenever	whv
japanese	jp
assistance	asi
height	heg
compete	cpe	competed	competing
essentially	esn
recover	rcv
criticism	cis
faculty	fau
achievement	acv
alcohol	alc
therapy	thp
offense	ofe
killer	kr
personality	pso
landscape	lan
deeply	dly
reasonable	ras
transition	trn
fairly	fay
column	cln
button	but
opponent	one
immigrant	img
distribution	dst
pregnant	peg
unable	ua
alternative	alt
violent	vio
portion	port
acquire	aqu
suicide	sic
stretch	stc	stretched	stretching
deficit	dfc
symptom	smp
complaint	cpl
capable	cab
analyze	aly	analyzed	analyzing
scared	sae
supporter	sor
twenty	twe
pretend	pnd	pretended	pretending
philosophy	phi
childhood	chd
wealth	wet
welfare	wef
poverty	pve
prosecutor	psc
spiritual	spu
double	dob	doubled	doubling
evaluate	eva
israeli	isa
knife	kf
detective	dct
disorder	dso
creature	cru
closely	cls
industrial	idu
housing	hoi
regardless	rge
numerous	num
command	cmd	commanded	commanding
shooting	sht
dozen	dz
exception	ecp
passion	pas
highway	hih
commander	cad
extreme	etr
publication	pul
fellow	few
mystery	myt
championship	cpi
install	itl
liberty	liy
beneath	beh
passenger	psn
physician	phs
graduate	gra
substance	sub
atmosphere	ats
muslim	mul
passage	psg
pepper	pee
emphasize	ez	emphasized	emphasizing
square	squ
recipe	rci
beside	bes
vegetable	veg
accomplish	acm
silent	sln
discovery	dsr
recovery	rce
territory	tet
girlfriend	gir
consist	cons	consisted	consisting
surely	suy
nervous	ner
immediate	imd
parking	prk
unusual	unu
engineering	egn
advance	ada
anonymous	aon
contemporary	coy
jail	jl	jailed	jailing
interpretation	ito
breakfast	brk
severe	see
profile	pfl
saving	sav
adjust	adu
reduction	rdu
constantly	cny
assist	ast
constant	csa
permit	pmi	permitted	permitting
primarily	pia
entertainment	eta
academy	acy
teaspoon	tes
transfer	trs
usual	uu
clinical	cin
avenue	avn
priest	pie
employment	epy
relax	rx	relaxed	relaxing
transform	trm
narrow	nao
ethnic	eth
scholar	scl
edition	edo
abandon	aba
practical	pal
infection	ife
musical	mua
suggestion	sge
resistance	rsa
prince	pnc
illness	iln
embrace	emb
republic	rpu
volunteer	vol	volunteered	volunteering
evaluation	evl
opposite	osi
awesome	awe
switch	swi	switched	switching
perceive	pci
fundamental	fua
phrase	phr
assumption	asm
designer	dsn
planning	plg
leading	led
widely	wid
occasion	oca
approximately	ax
retire	rti	retired	retiring
elsewhere	els
festival	fes
secure	scu
attach	ata	attached	attaching
mechanism	mec
intention	ien
scenario	snr
incredible	inb
spanish	san
strongly	srn
racial	ral
transportation	trp
boyfriend	boy
consideration	csd
retirement	rtr
rarely	rar
joint	jt
preserve	psr	preserved	preserving
enormous	enu
cigarette	cig
factory	fat
valuable	vau
electric	elc
submit	sbm
effectively	efc
monitor	moi
resolve	rsl
remaining	rma
participation	pao
stream	stm
origin	ori
congressional	cng
license	lic	licensed	licensing
twitter	twi
impose	imo
innocent	ioc
curriculum	cuc
insight	isg
investigator	ivg
hurricane	hur
accurate	aur
provision	pvi
communicate	cmc	communicated	communicating
vary	vy
jacket	jc
increasing	ica
equally	eqa
implication	imc
fiction	fic
protest	pst	protested	protesting
mama	mm
criteria	cie
potentially	pnt
assault	asa
dramatic	dra
enhance	eha
prospect	psp
settlement	sem
justify	js
formal	fom
virtually	vir
gallery	gal
tension	tns
throat	toa
reputation	rpa
index	ix
normally	nom
enterprise	enp
salary	sal
moreover	mor
cousin	csn
ordinary	oy
evolution	evo
helpful	hel
competitive	cmv
lovely	lov
fishing	fih
anxiety	ant
carbon	crb
islamic	ism
stranger	sag
urge	ug	urged	urging
fifth	ff
formula	foa
potato	poo
monster	mst
telephone	tep	telephoned	telephoning
excited	eci
criticize	crz	criticized	criticizing
prisoner	pir
discipline	dsp
negotiation	nea
butter	bue
desert	drt	deserted	deserting
complicated	cpc
prize	pz
assign	asg
bullet	ble
awareness	awa
sequence	sqe
illustrate	ilu
provider	pvd
activist	atv
vacation	vac
gang	gg
privacy	piv
arrange	ara	arranged	arranging
penalty	pna
stomach	sma
concert	conc
originally	org
statistics	sai
electronic	elt
properly	ply
bureau	bur
and/or	a/
classic	csc
recommendation	rcm
exciting	ect
impression	ims
broken	bok
battery	bay
narrative	nav
delivery	dli
forgive	frg	forgiven	forgiving
visible	vib
heavily	hey
junior	jun
diversity	dve
string	sng
lawsuit	law
latter	lat
deputy	deu
restore	rsr
psychological	psh
besides	bei
intense	its
friendly	fry
hungry	hug
dominate	doi
testing	teg
fantasy	fan
absence	abe
offensive	ofs
symbol	smb
recognition	rcg
detect	dee
tablespoon	tab
construct	csr
approval	aro
whereas	whr
defensive	dfs
independence	idn
apologize	api	apologized	apologizing
involvement	ivo
permanent	pma
whisper	whi	whispered	whispering
airline	ail
founder	fon
objective	obc
nowhere	now
phenomenon	phe
evolve	elv
silver	siv
universal	une
teenager	tna
crucial	cua
viewer	vw
ridiculous	rid
chocolate	choc
sensitive	sns
grandmother	grn
missile	msi
roughly	rou
constitutional	csu
adventure	ade
genetic	gc
related	rte
ultimate	ult
manufacturer	mau
unknown	uk
survival	sua
dimension	dim
resist	ris
darkness	dar
guarantee	gua	guaranteed	guaranteeing
historic	his
educator	edc
personnel	psl
confront	cfr
terrorist	tor
occupy	ocu
emphasis	ema
destruction	dsu
proceed	pcd	proceeded	proceeding
violate	vil
finance	fia
champion	cpn
advise	ads	advised	advising
initially	ity
advanced	adn
unlikely	uy
barrier	bai
advocate	avo
horrible	hor
burden	bun
violation	vit
unlike	unl
lifetime	lif
working	wok
ongoing	ong
routine	rot
presentation	psi
mexican	mex
stadium	sad
translate	tan	translated	translating
mortgage	mog
sheriff	she
clinic	cii
coalition	cio
naturally	nal
hopefully	hop
smooth	smo
advertising	avr
interpret	ier
dismiss	dsm
apparent	apn
arrangement	arn
incorporate	ico
brilliant	bia
storage	sog
framework	fra
honestly	hot
assure	asr	assured	assuring
utility	uti
aggressive	ags
cookie	cok
terror	teo
wealthy	weh
update	upa
alliance	ali
possess	pose	possessed	possessing
empire	emi
curious	cuo
calculate	calc	calculated	calculating
testimony	tey
elementary	eln
precisely	pcs
substantial	sbs
depending	dni
glance	gla
tissue	tis
concentration	cei
developer	dvl
ballot	bao
consume	csm
overcome	ovr
biological	bio
chamber	chb
similarly	sir
developing	dvp
expansion	epa
encounter	ecu
occasionally	ocs
unemployment	unp
laboratory	lab
administrator	ami
quarterback	qb
rocket	roc
preparation	prep
relative	rav
confident	cfe
strategic	srt
marine	mri
publisher	puh
innovation	iov
highlight	hil	highlighted	highlighting
fighter	fit
electricity	ely
instance	isn
fortune	frt
freeze	frz	frozen	freezing
variation	vai
negotiate	ngo
laughter	lag
wisdom	wio
correspondent	crd
mixture	mix
assistant	asn
retain	rta
tomato	tma
testify	tef	testified	testifying
ingredient	igr
galaxy	gx
qualify	ql
scheme	scm
concentrate	cta	concentrated	concentrating
contest	cts
introduction	itu
boundary	bou
versus	ver
regularly	rgy
tongue	tou
palestinian	pni
fiscal	fil
accompany	acp
terrorism	toi
respondent	rsn
narrator	nra
voting	vot
refugee	rfg
assembly	asb
limitation	lia
partnership	pah
representation	rps
ministry	miy
register	rgs
comedy	cmy
infrastructure	ifr
organic	ora
diverse	dvr
intellectual	iel
absolute	abl
dialogue	dal
frequency	frc
external	etn
appointment	aoi
convert	cvr
surprising	srs
mobile	mob
establishment	esb
worried	woi
shopping	shp
celebrity	ceb
congressman	cgr
impress	ipr	impressed	impressing
taxpayer	tax
publicly	puy
clothing	clh
rapidly	rap
domain	doa
mainly	mal
ceiling	ceg
shelter	shl	sheltered	sheltering
random	ram
obligation	obl
shower	shw
asleep	asl
musician	mun
extraordinary	eto
ceremony	cem
guideline	gud
comfort	cfo	comforted	comforting
pregnancy	pny
borrow	bow	borrowed	borrowing
conventional	cvt
tourist	tos
incentive	icn
custom	cum
tournament	tur
satellite	slt
nearby	neb
comprehensive	coh
stable	sab
medication	mdi
script	scp
educate	eda	educated	educating
efficient	efi
psychology	pyc
economics	ecn
nevertheless	nev
thirty	thy
charity	chy
friendship	fp
motivation	moa
differently	dfr
reserve	rese
observer	ose
humanity	hum
survivor	surv
quietly	qy
funeral	fue
spokesman	sok
extension	ets
historian	hit
chemical	cia
singer	sne
specialist	spl
missing	mig
distribute	dsb
reflection	rfl
shortly	shr
database	dat
remote	rmo
permission	pms
remarkable	rek
everyday	evr
lifestyle	lil
naked	nd
sufficient	sfi
consumption	cnp
capability	cpy
emission	ems
sidebar	sib
dealer	dae
measurement	meu
impressive	imv
fantastic	fta
adviser	avi
yield	yi	yielded	yielding
imagination	imt
radical	rdi
tragedy	trg
consultant	csl
lieutenant	lin
attractive	atc
drawing	drw
defeat	dfa
scandal	snd
ambassador	amb
counter	coun	countered	countering
horror	hro
vulnerable	vul
prevention	pvn
segment	sgm
constitute	cti
literary	lte
implementation	ipl
legitimate	lem
slight	slg
desperate	desp
distant	dnt
preference	pfr
politically	plc
feedback	fec
italian	ial
detailed	dai
cooperation	cpr
profession	pfs
incredibly	icd
orange	orn
killing	kil
photographer	pht
running	run
engagement	ega
differ	dff
extensive	eti
divorce	dvc	divorced	divorcing
vessel	ves
assignment	aig
distinction	dnc
circuit	circ
canadian	cdi
efficiency	efy
memorial	mol
proposed	psd
entity	eny
iphone	iph
punishment	pun
romantic	rom
economist	ecm
decent	dcn
poetry	poe
thread	ted
wooden	wde
confuse	cfu
privilege	pil
characterize	caz
decrease	dcr
resort	ror
legacy	lec
frankly	frk
cancel	cce
derive	drv
formation	frm
grandfather	grd
margin	mrg
exhibition	exb
legislature	lel
furthermore	fur
portrait	pit
sustain	sust
uniform	uno
painful	paf
miracle	mic
zero	ze
tactic	tac
inflation	ifa
hunting	hut
physically	phc
temporary	tmp
steady	sed
headline	hed
sudden	sde
successfully	scs
defendant	dfd
satisfy	sas	satisfied	satisfying
entrance	etc
aircraft	aic
withdraw	wih
cabinet	cbi
repeatedly	rpy
happiness	hap
admission	ams
correlation	cto
proportion	prop
dispute	dut
reward	rew
counselor	cso
recording	rcr
explosion	elo
appoint	aot
cognitive	cgn
furniture	fir
significance	sgn
grateful	grt
commissioner	comi
tremendous	tru
warrior	wai
physics	pyi
garage	gag
flavor	fla
squeeze	sqz	squeezed	squeezing
prominent	pme
satisfaction	sac
discrimination	dcm
recession	rcs
allegation	ale
weekly	wey
lately	lae
restriction	rsc
diamond	dao
conviction	cvc
playoff	plo
actress	ars
format	fma
controversy	ctv
grocery	grc
headquarters	heu
regulate	rul
olympic	oly
celebration	clb
handful	had
copyright	cph
dependent	dne
signature	sga
bishop	bis
strengthen	srh	strengthened	strengthening
entitle	etl
whoever	who
carrier	cari
anniversary	anv
ethics	ehi
legend	lge
scholarship	shs
membership	meb
standing	sdn
possession	posi
treaty	try
partly	prl
consciousness	coni
manufacturing	maf
announcement	aou
makeup	map
prediction	pct
stability	say
norm	nm
genius	gei
gently	get
operator	opa
tendency	tnd
subsequent	sbe
explode	eld	exploded	exploding
controversial	ctl
maintenance	mte
courage	cug
exceed	ecd
principal	pip
vaccine	van
identification	idf
sandwich	saw
twelve	twl
mainstream	mam
presidency	pid
integrity	ieg
distinct	dist
intelligent	iei
secondary	scy
hypothesis	hyp
fifteen	fif
nomination	non
adjustment	aju
sanction	sao
render	rnd
acceptable	acb
mutual	mut
examination	eam
meaningful	mef
communist	comu
superior	supe
currency	cuy
collective	clv
guitar	gut
doctrine	dot
commerce	come
invent	ivn	invented	inventing
respectively	rpc
particle	pcl
moderate	mde
jazz	jz
infant	ift
summary	smr
server	srr
leather	leh
radiation	rda
prompt	pmp
composition	cps
operating	ort
assert	aer	asserted	asserting
discourse	dco
wildlife	wif
soccer	soe
mandate	mda
downtown	dow
nightmare	nig
barrel	brr
homeless	hom
uncomfortable	unc
execute	eut
gesture	ges
receiver	riv
horizon	hoz
diagnosis	das
considerable	csb
gospel	gos
automatically	auo
fighting	fgh
stroke	srk	stroked	stroking
wander	wan	wandered	wandering
remark	rmr
fabric	fab
civilization	civ
corruption	cup
collapse	clp
ma'am	m'
greatly	gre
workshop	wos
inquiry	iqu
admire	amr	admired	admiring
exclude	elu
closet	coe
reporting	rpi
touchdown	toc
experimental	epr
earnings	ear
hunter	hue
tunnel	tun
behave	bev	behaved	behaving
motivate	mti
attribute	atu
elderly	ede
virtual	vrt
minimum	mim
weakness	wak
progressive	pog
medium	mdu
virtue	vie
athletic	atl
confusion	cfs
legislative	lev
facilitate	fae
midnight	mih
undergo	unr
heritage	het
summit	smi
telescope	tle
donate	don
agriculture	agi
enforce	efr
recruit	rcu
concerning	crg
integrate	iea
prescription	pcr
retail	rtl
adoption	aop
monthly	moh
deadly	dad
reliable	ria
transaction	trc
consistently	cil
bubble	bub	bubbled	bubbling
briefly	brf
absorb	abr
princess	pne
blanket	bla
kingdom	km
anticipate	anp
dedicate	dca
nominee	nin
transformation	tas
temple	tml
arrival	aiv
frustration	frs
changing	cgi
demonstration	dms
pollution	put
poster	pte
nonprofit	nop
guidance	gun
exhibit	ehb
interrupt	ieu	interrupted	interrupting
bankruptcy	ban
resign	rsg
dominant	dmi
invasion	iva
sacred	srd
replacement	rpm
portray	pora
distinguish	dih
consensus	cone
hardware	haw
korean	ka
dining	dng
tobacco	tob
orientation	ore
trigger	tig
wherever	wer
punish	pns	punished	punishing
depict	dpi
input	iu
seemingly	smg
widespread	wip
competitor	comp
freshman	frh
donation	dna
administrative	amt
gradually	gru
overlook	ovl
toilet	tol
pleased	pld
resemble	rsm
ideology	ido
maximum	max
starting	star
reservation	rvt
disappointed	dsd
instructor	isc
rescue	rsu	rescued	rescuing
racism	rim
pension	pno
diabetes	dab
cluster	clus
marijuana	mru
combat	cba
costume	ctu
frequent	feu
inspiration	iso
concrete	conr
cooking	cki
conspiracy	csp
institutional	ion
garlic	gai
drinking	drn
crystal	cry
helicopter	hec
counsel	cous
equation	eqt
sophisticated	sop
timing	tim
ethical	ehc
indication	idc
motive	mtv
reinforce	rin
gaze	gz	gazed	gazing
written	wre
reverse	rvr	reversed	reversing
starter	stat
injure	iju	injured	injuring
chronic	chro
continued	ctn
exclusive	ecs
colonel	colo
abroad	ard
thanksgiving	thk
intensity	iet
basement	bam
associated	asd
fascinating	fag
interact	iec
illustration	ils
essence	esen
container	cont
driving	drg
dynamic	dyn
promotion	pmo
uncertainty	una
ownership	own
officially	ofc
documentary	dor
turkey	tuk
diagnose	dno
precious	pco
swallow	swa
initiate	iae
fitness	ftn
restrict	rtc
unexpected	ux
agricultural	agc
sacrifice	scf
spectrum	srm
dragon	dro
bacteria	bct
pastor	pto
adequate	aeu
tackle	tak
occupation	ocp
compose	como
stimulus	smu
patent	ptn
powder	pwd
harsh	hh
surprisingly	sry
correctly	cey
govern	gor
modest	mds
shared	shd
psychologist	pyh
servant	serv
overwhelming	ovw
elevator	ela
hispanic	hip
divine	dvn
transmission	tam
commonly	cly
cowboy	cow
intent	inn
counseling	csg
gentle	gel
rhythm	rhy
complexity	cpx
nonetheless	nol
effectiveness	eft
lonely	lon
statistical	stai
longtime	log
garbage	gab
devote	dvt
venture	ven	ventured	venturing
subtle	sbl
civilian	cvl
endure	end
basket	bsk
strict	src
franchise	fah
prosecution	psu
lyrics	lyr
compound	cpu
architecture	arc
destination	dest
province	pvc
lecture	leu	lectured	lecturing
genuine	geu
upstairs	ups
trading	tad
acceptance	acn
revelation	rvl
indicator	ida
collaboration	cbo
rhetoric	rhe
inevitable	iev
monkey	mok
protocol	proc
productive	puv
companion	coma
convict	conv
recipient	rcp
practically	pca
persuade	pua
undermine	ude
endless	edl
translation	tat
conservation	cev
habitat	hab
contractor	ctc
trailer	tai
pitcher	pih
goodbye	god
dramatically	drm
caller	cll
hook	hk	hooked	hooking
behavioral	ber
boring	boi
suspend	susp	suspended	suspending
cholesterol	chol
closed	cld
advertisement	avt
bombing	bom
consult	conu
expertise	ert
creator	crea
peaceful	pau
provided	prov
tablet	tae
ruling	rug
warming	wam
equity	eqi
rational	rto
utilize	uz
bitter	bit
surgeon	sgo
affordable	afd
tennis	tni
artistic	ais
download	dod
suffering	sfe
accuracy	aua
literacy	ltr
treasury	teu
talented	tln
importantly	imy
invisible	ivb
sergeant	serg
regulatory	rgo
colony	coo
walking	wal
accessible	acl
integration	iga
spouse	sos
excitement	eit
residence	rsd
adolescent	adl
greek	gk
oxygen	ox
gravity	grv
functional	fuo
palace	paa
cotton	ctt
estimated	esm
endorse	edr
lawmaker	lam
determination	dma
simultaneously	siy
dynamics	dya
administer	ain
christianity	ciy
distract	drc
alleged	alg
statute	sau
biology	big
follower	fow
evident	evd
confess	cofe	confessed	confessing
eligible	elg
consent	cose	consented	consenting
bloody	bld
occasional	oci
prohibit	prh
sustainable	snb
banking	bag
asshole	ash
journalism	jor
obstacle	ost
bastard	bad
apology	apy
architect	arh
harbor	hao
handsome	has
bullshit	bus
inspector	ise
surveillance	sla
trauma	tau
rebuild	rbu
romance	roa
deadline	dln
classical	clas
convey	cvy
compensation	coms
insect	ict
output	out
parliament	pam
opposed	osd
separation	son
eating	eai
structural	stru
equality	eql
logical	loi
probability	prb
generous	gne
acquisition	aqi
custody	cud
compromise	cpm
judicial	jud
earthquake	ek
insane	ian
realistic	rit
assemble	aem
necessity	nec
parameter	pmt
grip	gp	gripped	gripping
modify	mof
sponsor	sno
mathematics	mah
hallway	hal
liability	lai
theoretical	thc
condemn	cde
homeland	hoa
technological	tch
anchor	aho
considering	cid
conscious	cono
vitamin	vm
known	kw
hostage	hog
actively	aty
teenage	tng
retrieve	rtv
processing	pcn
sentiment	sme
offering	ofr
convinced	cvd
photography	phg
laptop	lap
bounce	bon	bounced	bouncing
goodness	gon
affiliation	afl
blessing	bls
continuous	coti
landing	lad
repair	rir	repaired	repairing
ritual	ril
historically	hio
reminder	rmd
slavery	slv
supervisor	spv
quantity	qua
olympics	olm
pleasant	plea
outlet	oul
curtain	curt
declaration	dla
immune	imu
calendar	ced
paragraph	para
identical	idl
regret	ree	regreted	regreting
quest	qs
entrepreneur	etu
specify	spy
stumble	sml
outstanding	ous
manipulate	mip
airplane	aip
portfolio	pfo
mysterious	myr
delicious	dlc
northwest	nos
profound	pfu
treasure	tsu
lightly	lig
default	dfu
alongside	alo
isolate	iol
exploration	era
enroll	ero
charter	char
southwest	suh
upcoming	upc
someday	soy
courtesy	cty
statue	stt
precise	prec
cruise	cui
legally	ley
embassy	eba
patience	pati
thereby	thb
purple	pup
electrical	ecr
outfit	ouf
retired	reti
sidewalk	siw
runner	rue
attraction	aio
artificial	arf
indigenous	ids
dancer	dac
candle	cdl
sexually	sex
needle	ned
hidden	hid
chronicle	chrn
suburb	sbu
underlying	uny
sensor	seo
deploy	dlo
magnitude	mgn
suspicion	susi
colonial	coln
grandma	grm
jurisdiction	jur
iranian	ira
parade	pad
archive	ahi
gifted	gif
outdoor	oud
ending	edn
altogether	alh
burning	bug
reception	rcn
premise	prem
automatic	aum
mechanical	mch
credibility	cdy
loyalty	loy
promising	pmg
traveler	tav
metaphor	mep
pursuit	purs
therapist	tap
backup	bau
workplace	wop
instinct	inst
export	ept
seventh	seve
fixed	fx
broadcast	brc	broadcast	broadcasting
disclose	dsl	disclosed	disclosing
execution	euo
chuckle	chk
density	dns
correction	core
kinda	kd
relieve	reli
teammate	tmt
corridor	cdo
enthusiasm	etm
extended	exte
alright	aih
productivity	pcv
railroad	rod
frozen	fro
minimize	miz
inspection	ipe
expected	epc
nonsense	nse
theology	thl
terrific	tif
accent	aen
invitation	iai
oversee	ors
awkward	awk
registration	rgn
suburban	sbr
momentum	mtu
instantly	iay
hockey	hoc
proposition	pros
ancestor	aet
creativity	crv
casual	caa
objection	obi
clever	clr
revolutionary	rvu
carbohydrate	crh
reportedly	rol
forehead	foh
resume	rum
carpet	cpt
interior	iri
questionnaire	que
departure	dau
behalf	bef
diplomatic	dlm
subsidy	sbi
fossil	fsi
patrol	ptr
mechanic	mca
screening	scg
continuing	cong
electoral	eca
supposedly	sdl
dignity	dny
prophet	poh
commentary	comt
serving	seri
safely	sfl
homework	how
allegedly	ald
android	and
insert	irt
mortality	moy
contend	cond	contended	contending
elephant	elp
solely	sly
continent	cotn
ecosystem	ecy
syndrome	sdr
abstract	abc
accusation	aun
coming	cmg
pickup	pik
shuttle	shu
improved	ipo
calculation	calu
innovative	ioa
demographic	deh
accommodate	aom
unfair	ufa
tragic	tag
comprise	comr
faster	fst
nutrition	nut
mentor	mto
stance	snc
rabbit	rab
contributor	cib
cooperate	cope
hesitate	hes
offend	ofd	offended	offending
exploit	expl
likelihood	lik
sibling	sbn
southeast	sout
gorgeous	gog
undertake	unk
painter	pnr
residential	rde
counterpart	cep
believer	bli
inmate	inm
thoroughly	thg
filter	flt
pillow	piw
likewise	liw
passing	pig
vanish	vas	vanished	vanishing
instructional	iru
mentally	mta
neutral	neu
shield	shi
popularity	piy
cartoon	cart
authorize	auh
combined	cbn
graphic	grp
darling	dlg
traditionally	tao
vendor	ved
conceive	coce
descend	dcd
firmly	fim
beloved	blv
openly	opl
gathering	gah
preach	peh	preached	preaching
interfere	itf	interfered	interfering
required	rqi
capitalism	cim
meantime	mtm
presumably	peb
illusion	ili
removal	rmv
anxious	axi
organism	orm
sculpture	slp
harassment	ham
diminish	dsh
helmet	hem
certificate	cef
tribal	trb
sunlight	snl
delete	dle
rookie	rok
clarify	clf
hunger	hge
practitioner	prac
performer	pmr
protective	proi
programming	png
salmon	slm
census	css
accomplishment	aol
conscience	cosc
fortunately	foy
minimal	mini
molecule	moc
supportive	stv
threshold	trh
inventory	ivr
monetary	mtr
transport	tnp	transported	transporting
influential	ifu
verbal	veb
ranking	rak
puzzle	puz
envelope	evp
classify	csf
unfortunate	ufo
scatter	scat	scattered	scattering
readily	ray
discount	dcu
addiction	ait
emerging	emg
worthy	wot
marker	mrk
businessman	bum
premium	pmu
retailer	reta
protester	pror
outlook	ouo
gallon	gao
additionally	ady
ignorance	igo
chemistry	chem
sometime	smt
fraction	fct
conversion	cvo
tolerate	tla
citizenship	ciz
coordinator	cdn
validity	vad
lightning	lih
turtle	tut
ambition	abn
worldwide	wol
delicate	dlt
hostile	hst
instruct	irc	instructed	instructing
shortage	shg
useless	usl
suspicious	susc
transit	tnt
excite	eie	excited	exciting
publishing	pug
curiosity	curi
rolling	roi
disclosure	dcs
denial	dnl
secular	secu
speculation	spec
sympathy	smy
tender	tne
inappropriate	iap
o'clock	o'
sodium	sdu
challenging	chal
reliability	rib
hormone	hrm
footage	fte
coastal	coas
partial	part
flexible	fle
experienced	eri
mixed	mx
vampire	vp
optimistic	opm
dessert	dese
northeast	noa
specialize	spz
availability	avl
compliance	coml
astronomer	arm
forbid	fob
installation	iao
exclusively	ecv
shallow	slw
equivalent	eqv
betray	bry
willingness	wig
banker	bnk
interval	irv
gasoline	gas
encouraging	ecg
bucket	buc
laundry	lay
constraint	cona
hatred	hat
jewelry	jw
migration	mgr
invention	inve
loving	lvi
revenge	rvn
unprecedented	upr
outline	oun
halloween	hae
sweetheart	swe
lazy	lz
intimate	itm
defender	dnr
technically	tcn
peanut	pnu
unclear	ucl
workout	wou
wilderness	wir
compelling	comg
eleven	eev
backyard	bck
partially	pari
guardian	gur
passionate	pasi
scripture	scri
ideological	iog
thrive	thv
sensitivity	snv
emotionally	ety
ignorant	ior
explicitly	eic
unfold	ufl
headache	heh
eternal	ern
spectacular	spet
deposit	dos
verdict	vei
accountability	aoa
nominate	nia
uncover	uco
critique	crit
tropical	top
annually	aul
eighth	eig
corrupt	coru
compassion	copa
scratch	sah	scratched	scratching
verify	vf
offender	ond
inherit	ihe
strive	sve
appreciation	apc
canvas	cav
proceedings	pcg
magical	mgi
desperately	dry
throne	thn
brutal	bru
propaganda	proa
projection	pje
parental	pnl
disabled	dld
collector	cole
disappointment	dap
happily	hai
listener	lst
drawer	daw
developmental	dvm
socially	soci
courtroom	ctm
trainer	tin
induce	iuc
anytime	ayt
morality	mra
syrian	syr
pipeline	pipe
instant	insa
doorway	doy
interface	ief
learner	lne
placement	plm
conception	conp
flexibility	flx
elegant	ean
locker	lok
goddamn	goa
import	iot
philosophical	phl
bicycle	bic
destiny	desi
ambitious	amu
unbelievable	unb
halfway	haf
jealous	jea
invade	ivd
excessive	eiv
countless	cout
sunset	sse
accounting	acg
faithful	faf
freely	fey
extract	eac
adaptation	adap
depressed	drd
emperor	empe
columnist	colu
jungle	jug
embarrassed	emd
trillion	til
breeze	bz
foster	fse
discourage	dcg
disturbing	dur
isolation	ioi
explicit	expi
commodity	comd
attendance	aed
consequently	conl
streak	sak
similarity	simi
dancing	danc
petition	peti
viable	vab
breathing	brh
balloon	bln
monument	mum
reluctant	ruc
warrant	wat
tattoo	ttt
softly	sft
graduation	gri
deliberately	dlb
consecutive	cuv
upgrade	upe
accurately	aue
strictly	stri
casualty	casu
banana	bna
beneficial	bec
shrink	shk
testament	tst
browser	brw
processor	prce
perceived	perc
talking	tlk
merchant	mrc
quantum	qm
eyebrow	eye
surrounding	suro
vocabulary	voc
ashamed	aha
stunning	stun
murderer	mud
burger	bge
textbook	tex
sensation	sens
afterward	afw
hammer	hmm	hammered	hammering
keyboard	ky
persist	pers
predator	pred
bizarre	biz
